villcode,county,district,village,agree_2025,disagree_2025,2021_agree,2021_disagree,agree_diff,disagree_diff,agree_pct_change,disagree_pct_change
66000110001,臺中市,大甲區,朝陽里,232,80,260,317,-28,-237,-10.769,-74.763
66000110002,臺中市,大甲區,大甲里,177,61,183,252,-6,-191,-3.279,-75.794
66000110003,臺中市,大甲區,順天里,317,93,302,381,15,-288,4.967,-75.591
66000110004,臺中市,大甲區,孔門里,150,34,147,142,3,-108,2.041,-76.056
66000110005,臺中市,大甲區,平安里,408,95,349,437,59,-342,16.905,-78.261
66000110006,臺中市,大甲區,庄美里,438,132,387,496,51,-364,13.178,-73.387
66000110007,臺中市,大甲區,新美里,711,183,651,679,60,-496,9.217,-73.049
66000110008,臺中市,大甲區,岷山里,456,92,382,386,74,-294,19.372,-76.166
66000110009,臺中市,大甲區,中山里,1058,220,888,817,170,-597,19.144,-73.072
66000110010,臺中市,大甲區,南陽里,173,40,154,172,19,-132,12.338,-76.744
66000110011,臺中市,大甲區,薰風里,205,34,168,229,37,-195,22.024,-85.153
66000110012,臺中市,大甲區,義和里,703,146,562,579,141,-433,25.089,-74.784
66000110013,臺中市,大甲區,武陵里,277,47,227,225,50,-178,22.026,-79.111
66000110014,臺中市,大甲區,文曲里,207,45,132,222,75,-177,56.818,-79.73
66000110015,臺中市,大甲區,武曲里,417,98,333,369,84,-271,25.225,-73.442
66000110016,臺中市,大甲區,文武里,1130,297,1003,1059,127,-762,12.662,-71.955
66000110017,臺中市,大甲區,奉化里,490,122,404,391,86,-269,21.287,-68.798
66000110018,臺中市,大甲區,德化里,361,74,255,380,106,-306,41.569,-80.526
66000110019,臺中市,大甲區,江南里,267,56,216,251,51,-195,23.611,-77.689
66000110020,臺中市,大甲區,頂店里,996,235,776,894,220,-659,28.351,-73.714
66000110021,臺中市,大甲區,太白里,247,55,176,251,71,-196,40.341,-78.088
66000110022,臺中市,大甲區,孟春里,719,192,594,779,125,-587,21.044,-75.353
66000110023,臺中市,大甲區,幸福里,424,129,347,503,77,-374,22.19,-74.354
66000110024,臺中市,大甲區,日南里,1082,254,836,974,246,-720,29.426,-73.922
66000110025,臺中市,大甲區,龍泉里,303,78,258,319,45,-241,17.442,-75.549
66000110026,臺中市,大甲區,西岐里,360,90,282,312,78,-222,27.66,-71.154
66000110027,臺中市,大甲區,銅安里,251,39,187,245,64,-206,34.225,-84.082
66000110028,臺中市,大甲區,福德里,202,44,182,193,20,-149,10.989,-77.202
66000110029,臺中市,大甲區,建興里,225,53,174,265,51,-212,29.31,-80.0
66000220001,臺中市,大安區,南埔里,147,49,130,225,17,-176,13.077,-78.222
66000220002,臺中市,大安區,南庄里,178,59,160,195,18,-136,11.25,-69.744
66000220003,臺中市,大安區,中庄里,494,134,361,499,133,-365,36.842,-73.146
66000220006,臺中市,大安區,東安里,281,83,183,266,98,-183,53.552,-68.797
66000220005,臺中市,大安區,福興里,221,55,171,225,50,-170,29.24,-75.556
66000220004,臺中市,大安區,龜?里,277,51,243,279,34,-228,13.992,-81.72
66000220007,臺中市,大安區,頂安里,162,37,163,173,-1,-136,-0.613,-78.613
66000220008,臺中市,大安區,永安里,285,60,255,304,30,-244,11.765,-80.263
66000220009,臺中市,大安區,福住里,198,35,147,188,51,-153,34.694,-81.383
66000220010,臺中市,大安區,海墘里,277,45,225,227,52,-182,23.111,-80.176
66000220011,臺中市,大安區,西安里,333,71,286,321,47,-250,16.434,-77.882
66000220012,臺中市,大安區,松雅里,245,79,180,257,65,-178,36.111,-69.261
66000210001,臺中市,外埔區,永豐里,269,52,204,182,65,-130,31.863,-71.429
66000210002,臺中市,外埔區,六分里,556,122,417,357,139,-235,33.333,-65.826
66000210004,臺中市,外埔區,大同里,1169,201,967,800,202,-599,20.889,-74.875
66000210006,臺中市,外埔區,大東里,1473,317,1211,1127,262,-810,21.635,-71.872
66000210003,臺中市,外埔區,三崁里,435,100,314,307,121,-207,38.535,-67.427
66000210005,臺中市,外埔區,水美里,818,197,632,619,186,-422,29.43,-68.174
66000210009,臺中市,外埔區,鐵山里,478,97,382,320,96,-223,25.131,-69.688
66000210008,臺中市,外埔區,中山里,345,61,279,239,66,-178,23.656,-74.477
66000210007,臺中市,外埔區,馬鳴里,321,72,227,246,94,-174,41.41,-70.732
66000210010,臺中市,外埔區,土城里,281,85,251,343,30,-258,11.952,-75.219
66000210011,臺中市,外埔區,廍子里,195,44,167,180,28,-136,16.766,-75.556
66000120001,臺中市,清水區,鰲峰里,218,79,209,254,9,-175,4.306,-68.898
66000120002,臺中市,清水區,靈泉里,213,61,208,254,5,-193,2.404,-75.984
66000120003,臺中市,清水區,清水里,497,146,412,500,85,-354,20.631,-70.8
66000120004,臺中市,清水區,文昌里,122,44,130,178,-8,-134,-6.154,-75.281
66000120005,臺中市,清水區,南寧里,355,110,351,414,4,-304,1.14,-73.43
66000120006,臺中市,清水區,西寧里,309,113,277,383,32,-270,11.552,-70.496
66000120007,臺中市,清水區,北寧里,160,57,141,183,19,-126,13.475,-68.852
66000120008,臺中市,清水區,中興里,97,44,91,119,6,-75,6.593,-63.025
66000120009,臺中市,清水區,西社里,452,130,413,541,39,-411,9.443,-75.97
66000120010,臺中市,清水區,南社里,2450,680,1889,2219,561,-1539,29.698,-69.356
66000120011,臺中市,清水區,裕嘉里,267,81,230,310,37,-229,16.087,-73.871
66000120012,臺中市,清水區,臨江里,326,98,271,322,55,-224,20.295,-69.565
66000120013,臺中市,清水區,秀水里,1007,277,823,913,184,-636,22.357,-69.66
66000120014,臺中市,清水區,武鹿里,715,181,515,725,200,-544,38.835,-75.034
66000120015,臺中市,清水區,海濱里,379,120,323,470,56,-350,17.337,-74.468
66000120016,臺中市,清水區,槺榔里,1881,511,965,1333,916,-822,94.922,-61.665
66000120017,臺中市,清水區,中社里,903,150,822,360,81,-210,9.854,-58.333
66000120018,臺中市,清水區,高西里,221,42,225,171,-4,-129,-1.778,-75.439
66000120019,臺中市,清水區,高南里,214,69,202,245,12,-176,5.941,-71.837
66000120020,臺中市,清水區,高東里,217,84,168,244,49,-160,29.167,-65.574
66000120021,臺中市,清水區,高北里,195,36,151,183,44,-147,29.139,-80.328
66000120022,臺中市,清水區,高美里,265,54,216,229,49,-175,22.685,-76.419
66000120023,臺中市,清水區,國姓里,307,116,224,438,83,-322,37.054,-73.516
66000120024,臺中市,清水區,菁埔里,395,146,345,553,50,-407,14.493,-73.599
66000120025,臺中市,清水區,頂湳里,320,65,263,335,57,-270,21.673,-80.597
66000120026,臺中市,清水區,田寮里,351,115,284,515,67,-400,23.592,-77.67
66000120027,臺中市,清水區,橋頭里,1498,464,1201,1747,297,-1283,24.729,-73.44
66000120028,臺中市,清水區,下湳里,568,179,460,607,108,-428,23.478,-70.511
66000120029,臺中市,清水區,東山里,248,77,202,222,46,-145,22.772,-65.315
66000120032,臺中市,清水區,吳厝里,325,81,244,323,81,-242,33.197,-74.923
66000120030,臺中市,清水區,楊厝里,197,57,171,264,26,-207,15.205,-78.409
66000120031,臺中市,清水區,海風里,281,46,239,257,42,-211,17.573,-82.101
66000140001,臺中市,梧棲區,頂寮里,1309,326,668,758,641,-432,95.958,-56.992
66000140002,臺中市,梧棲區,下寮里,391,144,376,462,15,-318,3.989,-68.831
66000140003,臺中市,梧棲區,中正里,898,194,740,752,158,-558,21.351,-74.202
66000140004,臺中市,梧棲區,中和里,93,44,97,127,-4,-83,-4.124,-65.354
66000140005,臺中市,梧棲區,文化里,252,78,234,253,18,-175,7.692,-69.17
66000140006,臺中市,梧棲區,安仁里,160,41,158,172,2,-131,1.266,-76.163
66000140007,臺中市,梧棲區,草湳里,1320,348,1129,1281,191,-933,16.918,-72.834
66000140008,臺中市,梧棲區,南簡里,1198,332,840,1135,358,-803,42.619,-70.749
66000140009,臺中市,梧棲區,福德里,1022,275,748,1001,274,-726,36.631,-72.527
66000140010,臺中市,梧棲區,大庄里,1709,379,1383,1498,326,-1119,23.572,-74.7
66000140011,臺中市,梧棲區,大村里,1293,316,989,1201,304,-885,30.738,-73.689
66000140012,臺中市,梧棲區,興農里,642,176,359,469,283,-293,78.83,-62.473
66000140013,臺中市,梧棲區,永寧里,411,119,353,504,58,-385,16.431,-76.389
66000140014,臺中市,梧棲區,永安里,495,129,472,452,23,-323,4.873,-71.46
66000130001,臺中市,沙鹿區,居仁里,409,203,276,333,133,-130,48.188,-39.039
66000130002,臺中市,沙鹿區,洛泉里,651,339,495,534,156,-195,31.515,-36.517
66000130003,臺中市,沙鹿區,沙鹿里,212,149,175,292,37,-143,21.143,-48.973
66000130004,臺中市,沙鹿區,美仁里,177,90,116,118,61,-28,52.586,-23.729
66000130005,臺中市,沙鹿區,興仁里,823,348,503,578,320,-230,63.618,-39.792
66000130020,臺中市,沙鹿區,興安里,1256,530,627,821,629,-291,100.319,-35.445
66000130006,臺中市,沙鹿區,斗抵里,1638,647,918,1061,720,-414,78.431,-39.02
66000130007,臺中市,沙鹿區,鹿峰里,1957,856,1024,1310,933,-454,91.113,-34.656
66000130008,臺中市,沙鹿區,鹿寮里,2367,1272,1236,1894,1131,-622,91.505,-32.841
66000130009,臺中市,沙鹿區,竹林里,2650,930,1531,1548,1119,-618,73.089,-39.922
66000130010,臺中市,沙鹿區,犁分里,350,154,205,268,145,-114,70.732,-42.537
66000130012,臺中市,沙鹿區,福興里,1500,490,798,810,702,-320,87.97,-39.506
66000130011,臺中市,沙鹿區,北勢里,1830,684,937,933,893,-249,95.304,-26.688
66000130013,臺中市,沙鹿區,晉江里,698,246,367,405,331,-159,90.191,-39.259
66000130014,臺中市,沙鹿區,六路里,2013,735,1019,1195,994,-460,97.547,-38.494
66000130015,臺中市,沙鹿區,南勢里,1273,403,715,692,558,-289,78.042,-41.763
66000130016,臺中市,沙鹿區,埔子里,2476,722,1330,1185,1146,-463,86.165,-39.072
66000130021,臺中市,沙鹿區,三鹿里,3004,976,1544,1485,1460,-509,94.56,-34.276
66000130017,臺中市,沙鹿區,公明里,1529,492,1028,760,501,-268,48.735,-35.263
66000130018,臺中市,沙鹿區,清泉里,957,298,550,468,407,-170,74.0,-36.325
66000130019,臺中市,沙鹿區,西勢里,719,248,456,396,263,-148,57.675,-37.374
66000250001,臺中市,龍井區,竹坑里,1198,418,624,613,574,-195,91.987,-31.811
66000250002,臺中市,龍井區,龍東里,1096,378,562,599,534,-221,95.018,-36.895
66000250003,臺中市,龍井區,龍西里,696,252,416,356,280,-104,67.308,-29.213
66000250004,臺中市,龍井區,田中里,1463,559,732,846,731,-287,99.863,-33.924
66000250005,臺中市,龍井區,福田里,373,125,195,182,178,-57,91.282,-31.319
66000250006,臺中市,龍井區,麗水里,840,294,509,417,331,-123,65.029,-29.496
66000250007,臺中市,龍井區,龍津里,1564,683,825,1155,739,-472,89.576,-40.866
66000250008,臺中市,龍井區,三德里,926,376,415,626,511,-250,123.133,-39.936
66000250009,臺中市,龍井區,忠和里,1596,714,812,1159,784,-445,96.552,-38.395
66000250010,臺中市,龍井區,山腳里,2049,781,970,1216,1079,-435,111.237,-35.773
66000250011,臺中市,龍井區,龍泉里,3046,1052,1527,1559,1519,-507,99.476,-32.521
66000250012,臺中市,龍井區,龍崗里,1033,410,506,574,527,-164,104.15,-28.571
66000250013,臺中市,龍井區,新庄里,2048,825,1207,1321,841,-496,69.677,-37.547
66000250014,臺中市,龍井區,南寮里,565,255,294,410,271,-155,92.177,-37.805
66000250015,臺中市,龍井區,新東里,1588,646,1069,1010,519,-364,48.55,-36.04
66000250016,臺中市,龍井區,東海里,3077,1195,2098,1736,979,-541,46.663,-31.164
66000240001,臺中市,大肚區,王田里,1477,590,762,977,715,-387,93.832,-39.611
66000240002,臺中市,大肚區,中和里,328,143,179,231,149,-88,83.24,-38.095
66000240003,臺中市,大肚區,福山里,1181,539,687,803,494,-264,71.907,-32.877
66000240004,臺中市,大肚區,營埔里,579,196,316,326,263,-130,83.228,-39.877
66000240005,臺中市,大肚區,社腳里,921,324,568,526,353,-202,62.148,-38.403
66000240006,臺中市,大肚區,新興里,899,326,542,584,357,-258,65.867,-44.178
66000240007,臺中市,大肚區,大東里,1058,425,715,653,343,-228,47.972,-34.916
66000240008,臺中市,大肚區,大肚里,813,347,562,533,251,-186,44.662,-34.897
66000240009,臺中市,大肚區,永和里,282,132,208,189,74,-57,35.577,-30.159
66000240010,臺中市,大肚區,磺溪里,647,228,338,388,309,-160,91.42,-41.237
66000240011,臺中市,大肚區,永順里,584,262,334,433,250,-171,74.85,-39.492
66000240012,臺中市,大肚區,成功里,393,152,195,174,198,-22,101.538,-12.644
66000240013,臺中市,大肚區,山陽里,440,184,279,299,161,-115,57.706,-38.462
66000240014,臺中市,大肚區,頂街里,2741,969,1627,1574,1114,-605,68.47,-38.437
66000240015,臺中市,大肚區,瑞井里,1648,754,926,1126,722,-372,77.97,-33.037
66000240016,臺中市,大肚區,蔗廍里,1552,745,788,1152,764,-407,96.954,-35.33
66000240017,臺中市,大肚區,自強里,1242,450,800,701,442,-251,55.25,-35.806
66000230001,臺中市,烏日區,烏日里,3004,1432,1877,2234,1127,-802,60.043,-35.9
66000230002,臺中市,烏日區,湖日里,849,488,504,653,345,-165,68.452,-25.268
66000230003,臺中市,烏日區,三和里,2925,1205,1228,1269,1697,-64,138.192,-5.043
66000230004,臺中市,烏日區,榮泉里,2352,933,1263,1198,1089,-265,86.223,-22.12
66000230005,臺中市,烏日區,學田里,936,381,593,546,343,-165,57.841,-30.22
66000230006,臺中市,烏日區,九德里,4302,1914,2623,3171,1679,-1257,64.011,-39.64
66000230007,臺中市,烏日區,仁德里,2654,1194,1698,1870,956,-676,56.302,-36.15
66000230008,臺中市,烏日區,前竹里,493,296,312,486,181,-190,58.013,-39.095
66000230009,臺中市,烏日區,五光里,595,264,329,417,266,-153,80.851,-36.691
66000230010,臺中市,烏日區,光明里,697,370,403,538,294,-168,72.953,-31.227
66000230011,臺中市,烏日區,東園里,826,336,424,547,402,-211,94.811,-38.574
66000230012,臺中市,烏日區,溪埧里,1600,675,852,1072,748,-397,87.793,-37.034
66000230013,臺中市,烏日區,螺潭里,823,349,484,591,339,-242,70.041,-40.948
66000230014,臺中市,烏日區,北里里,519,277,309,443,210,-166,67.961,-37.472
66000230015,臺中市,烏日區,南里里,522,192,348,304,174,-112,50.0,-36.842
66000230016,臺中市,烏日區,溪尾里,324,89,218,148,106,-59,48.624,-39.865
66000260001,臺中市,霧峰區,桐林里,428,187,225,315,203,-128,90.222,-40.635
66000260002,臺中市,霧峰區,吉峰里,3153,1284,1959,2041,1194,-757,60.949,-37.09
66000260003,臺中市,霧峰區,甲寅里,1670,665,996,969,674,-304,67.671,-31.373
66000260004,臺中市,霧峰區,本鄉里,817,365,528,565,289,-200,54.735,-35.398
66000260005,臺中市,霧峰區,中正里,724,310,495,507,229,-197,46.263,-38.856
66000260006,臺中市,霧峰區,錦榮里,436,187,283,280,153,-93,54.064,-33.214
66000260007,臺中市,霧峰區,萊園里,328,172,215,271,113,-99,52.558,-36.531
66000260008,臺中市,霧峰區,本堂里,2094,784,1409,1254,685,-470,48.616,-37.48
66000260010,臺中市,霧峰區,北柳里,1382,583,769,991,613,-408,79.714,-41.171
66000260011,臺中市,霧峰區,南柳里,693,274,419,493,274,-219,65.394,-44.422
66000260012,臺中市,霧峰區,四德里,836,359,463,567,373,-208,80.562,-36.684
66000260013,臺中市,霧峰區,五福里,903,340,547,650,356,-310,65.082,-47.692
66000260018,臺中市,霧峰區,丁台里,765,348,406,668,359,-320,88.424,-47.904
66000260019,臺中市,霧峰區,北勢里,878,251,534,418,344,-167,64.419,-39.952
66000260020,臺中市,霧峰區,南勢里,408,187,265,291,143,-104,53.962,-35.739
66000260014,臺中市,霧峰區,萬豐里,779,403,460,643,319,-240,69.348,-37.325
66000260015,臺中市,霧峰區,舊正里,666,273,406,477,260,-204,64.039,-42.767
66000260009,臺中市,霧峰區,坑口里,1054,378,701,630,353,-252,50.357,-40.0
66000260016,臺中市,霧峰區,峰谷里,383,181,165,265,218,-84,132.121,-31.698
66000260017,臺中市,霧峰區,六股里,744,448,441,674,303,-226,68.707,-33.531
66000150001,臺中市,后里區,廣福里,718,221,496,280,222,-59,44.758,-21.071
66000150002,臺中市,后里區,仁里里,352,106,191,194,161,-88,84.293,-45.361
66000150003,臺中市,后里區,義里里,1069,325,695,496,374,-171,53.813,-34.476
66000150018,臺中市,后里區,義德里,878,275,531,437,347,-162,65.348,-37.071
66000150004,臺中市,后里區,后里里,1317,469,780,782,537,-313,68.846,-40.026
66000150005,臺中市,后里區,厚里里,798,321,405,422,393,-101,97.037,-23.934
66000150006,臺中市,后里區,墩東里,1655,604,982,932,673,-328,68.534,-35.193
66000150007,臺中市,后里區,墩西里,599,282,323,440,276,-158,85.449,-35.909
66000150008,臺中市,后里區,墩南里,1204,480,592,737,612,-257,103.378,-34.871
66000150009,臺中市,后里區,墩北里,1230,536,625,802,605,-266,96.8,-33.167
66000150010,臺中市,后里區,中和里,820,338,396,547,424,-209,107.071,-38.208
66000150011,臺中市,后里區,舊社里,714,290,390,425,324,-135,83.077,-31.765
66000150012,臺中市,后里區,聯合里,508,190,265,351,243,-161,91.698,-45.869
66000150013,臺中市,后里區,太平里,725,204,337,370,388,-166,115.134,-44.865
66000150014,臺中市,后里區,眉山里,1147,343,581,563,566,-220,97.418,-39.076
66000150017,臺中市,后里區,月眉里,627,290,304,471,323,-181,106.25,-38.429
66000150016,臺中市,后里區,公館里,690,264,323,411,367,-147,113.622,-35.766
66000150015,臺中市,后里區,泰安里,459,177,214,307,245,-130,114.486,-42.345
66000160001,臺中市,神岡區,神岡里,1068,446,597,639,471,-193,78.894,-30.203
66000160002,臺中市,神岡區,庄前里,870,359,432,523,438,-164,101.389,-31.358
66000160003,臺中市,神岡區,北庄里,889,455,445,610,444,-155,99.775,-25.41
66000160004,臺中市,神岡區,庄後里,699,394,337,601,362,-207,107.418,-34.443
66000160013,臺中市,神岡區,圳前里,758,304,418,468,340,-164,81.34,-35.043
66000160015,臺中市,神岡區,圳堵里,723,325,362,435,361,-110,99.724,-25.287
66000160014,臺中市,神岡區,新庄里,1205,595,560,896,645,-301,115.179,-33.594
66000160016,臺中市,神岡區,山皮里,346,175,144,269,202,-94,140.278,-34.944
66000160005,臺中市,神岡區,社口里,2529,1122,1186,1647,1343,-525,113.238,-31.876
66000160006,臺中市,神岡區,社南里,1664,782,785,1307,879,-525,111.975,-40.168
66000160007,臺中市,神岡區,三角里,882,425,401,678,481,-253,119.95,-37.316
66000160009,臺中市,神岡區,大社里,1506,613,757,929,749,-316,98.943,-34.015
66000160008,臺中市,神岡區,岸裡里,881,451,422,759,459,-308,108.768,-40.58
66000160010,臺中市,神岡區,豐洲里,2249,1093,1155,1626,1094,-533,94.719,-32.78
66000160011,臺中市,神岡區,神洲里,812,390,400,675,412,-285,103.0,-42.222
66000160012,臺中市,神岡區,溪洲里,947,401,439,672,508,-271,115.718,-40.327
66000180012,臺中市,大雅區,上雅里,1984,816,1047,1228,937,-412,89.494,-33.55
66000180001,臺中市,大雅區,大雅里,1555,607,875,909,680,-302,77.714,-33.223
66000180013,臺中市,大雅區,文雅里,2008,778,1217,1129,791,-351,64.996,-31.089
66000180007,臺中市,大雅區,三和里,1837,703,981,1059,856,-356,87.258,-33.617
66000180010,臺中市,大雅區,二和里,2175,788,1134,1182,1041,-394,91.799,-33.333
66000180011,臺中市,大雅區,四德里,1659,591,979,924,680,-333,69.459,-36.039
66000180008,臺中市,大雅區,西寶里,1554,653,785,963,769,-310,97.962,-32.191
66000180009,臺中市,大雅區,上楓里,2167,838,1037,1255,1130,-417,108.968,-33.227
66000180014,臺中市,大雅區,大楓里,1604,682,928,1026,676,-344,72.845,-33.528
66000180015,臺中市,大雅區,雅楓里,1217,438,663,665,554,-227,83.56,-34.135
66000180002,臺中市,大雅區,員林里,3289,1328,1648,1967,1641,-639,99.575,-32.486
66000180003,臺中市,大雅區,六寶里,2101,759,1279,1116,822,-357,64.269,-31.989
66000180004,臺中市,大雅區,秀山里,1195,472,615,730,580,-258,94.309,-35.342
66000180006,臺中市,大雅區,橫山里,1436,613,816,888,620,-275,75.98,-30.968
66000180005,臺中市,大雅區,忠義里,1413,333,959,334,454,-1,47.341,-0.299
66000170002,臺中市,潭子區,潭秀里,391,211,221,375,170,-164,76.923,-43.733
66000170003,臺中市,潭子區,潭北里,890,351,531,486,359,-135,67.608,-27.778
66000170001,臺中市,潭子區,潭陽里,3531,1501,1993,2323,1538,-822,77.17,-35.385
66000170004,臺中市,潭子區,福仁里,3943,1484,2170,2028,1773,-544,81.705,-26.824
66000170005,臺中市,潭子區,頭家里,1849,682,1151,1124,698,-442,60.643,-39.324
66000170014,臺中市,潭子區,頭家東里,1442,550,876,888,566,-338,64.612,-38.063
66000170015,臺中市,潭子區,家興里,2459,1004,1518,1379,941,-375,61.989,-27.194
66000170016,臺中市,潭子區,家福里,1643,676,1003,986,640,-310,63.809,-31.44
66000170006,臺中市,潭子區,甘蔗里,3338,1256,1931,1933,1407,-677,72.864,-35.023
66000170007,臺中市,潭子區,東寶里,3903,1783,2260,2743,1643,-960,72.699,-34.998
66000170008,臺中市,潭子區,大富里,1048,481,523,691,525,-210,100.382,-30.391
66000170009,臺中市,潭子區,大豐里,2171,919,1124,1432,1047,-513,93.149,-35.824
66000170010,臺中市,潭子區,栗林里,1743,775,884,1234,859,-459,97.172,-37.196
66000170011,臺中市,潭子區,嘉仁里,1307,594,642,965,665,-371,103.583,-38.446
66000170012,臺中市,潭子區,新田里,457,208,260,401,197,-193,75.769,-48.13
66000170013,臺中市,潭子區,聚興里,1306,545,726,843,580,-298,79.89,-35.35
66000060001,臺中市,西屯區,西安里,1302,334,1108,1154,194,-820,17.509,-71.057
66000060026,臺中市,西屯區,至善里,1099,297,1012,895,87,-598,8.597,-66.816
66000060024,臺中市,西屯區,西平里,1212,269,1181,778,31,-509,2.625,-65.424
66000060002,臺中市,西屯區,西墩里,1385,422,1140,1293,245,-871,21.491,-67.363
66000060003,臺中市,西屯區,潮洋里,1372,353,1139,1136,233,-783,20.457,-68.926
66000060004,臺中市,西屯區,龍潭里,220,91,156,254,64,-163,41.026,-64.173
66000060005,臺中市,西屯區,惠來里,3510,740,3286,2914,224,-2174,6.817,-74.605
66000060006,臺中市,西屯區,上石里,1238,272,1013,959,225,-687,22.211,-71.637
66000060027,臺中市,西屯區,上安里,1310,306,1185,1114,125,-808,10.549,-72.531
66000060028,臺中市,西屯區,上德里,1025,259,1025,845,0,-586,0.0,-69.349
66000060007,臺中市,西屯區,逢甲里,1143,270,897,854,246,-584,27.425,-68.384
66000060029,臺中市,西屯區,逢福里,1436,303,1312,1121,124,-818,9.451,-72.971
66000060008,臺中市,西屯區,鵬程里,1031,92,1055,188,-24,-96,-2.275,-51.064
66000060010,臺中市,西屯區,何厝里,718,181,628,724,90,-543,14.331,-75.0
66000060030,臺中市,西屯區,何明里,850,296,815,871,35,-575,4.294,-66.016
66000060025,臺中市,西屯區,何南里,1032,300,1027,938,5,-638,0.487,-68.017
66000060031,臺中市,西屯區,何成里,1728,430,1520,1547,208,-1117,13.684,-72.204
66000060009,臺中市,西屯區,何安里,1191,362,1051,1145,140,-783,13.321,-68.384
66000060021,臺中市,西屯區,何仁里,1459,436,1286,1363,173,-927,13.453,-68.012
66000060022,臺中市,西屯區,何德里,917,200,766,802,151,-602,19.713,-75.062
66000060032,臺中市,西屯區,何福里,1000,309,916,1035,84,-726,9.17,-70.145
66000060023,臺中市,西屯區,何源里,1665,448,1509,1361,156,-913,10.338,-67.083
66000060011,臺中市,西屯區,大河里,865,356,767,1030,98,-674,12.777,-65.437
66000060012,臺中市,西屯區,大石里,870,59,866,156,4,-97,0.462,-62.179
66000060013,臺中市,西屯區,大福里,790,187,764,594,26,-407,3.403,-68.519
66000060014,臺中市,西屯區,大鵬里,1233,317,1106,888,127,-571,11.483,-64.302
66000060015,臺中市,西屯區,港尾里,1249,312,1023,1098,226,-786,22.092,-71.585
66000060016,臺中市,西屯區,廣福里,458,146,420,628,38,-482,9.048,-76.752
66000060017,臺中市,西屯區,林厝里,773,176,762,666,11,-490,1.444,-73.574
66000060018,臺中市,西屯區,永安里,2869,655,2554,2433,315,-1778,12.334,-73.079
66000060019,臺中市,西屯區,福安里,804,189,695,653,109,-464,15.683,-71.057
66000060039,臺中市,西屯區,福雅里,1460,339,1298,1162,162,-823,12.481,-70.826
66000060038,臺中市,西屯區,福林里,1997,438,1869,1482,128,-1044,6.849,-70.445
66000060037,臺中市,西屯區,福瑞里,708,155,641,479,67,-324,10.452,-67.641
66000060036,臺中市,西屯區,福聯里,643,157,597,517,46,-360,7.705,-69.632
66000060033,臺中市,西屯區,福和里,785,263,698,1059,87,-796,12.464,-75.165
66000060034,臺中市,西屯區,福中里,729,168,680,693,49,-525,7.206,-75.758
66000060035,臺中市,西屯區,福恩里,1232,312,1209,1037,23,-725,1.902,-69.913
66000060020,臺中市,西屯區,協和里,1080,309,890,1042,190,-733,21.348,-70.345
66000070001,臺中市,南屯區,南屯里,1942,563,1830,1954,112,-1391,6.12,-71.187
66000070002,臺中市,南屯區,豐樂里,2758,778,2570,2648,188,-1870,7.315,-70.619
66000070003,臺中市,南屯區,楓樹里,1582,498,1306,1499,276,-1001,21.133,-66.778
66000070004,臺中市,南屯區,中和里,993,333,767,1094,226,-761,29.465,-69.561
66000070014,臺中市,南屯區,鎮平里,249,112,217,361,32,-249,14.747,-68.975
66000070005,臺中市,南屯區,春社里,1604,360,1286,1177,318,-817,24.728,-69.414
66000070006,臺中市,南屯區,春安里,974,180,261,231,713,-51,273.18,-22.078
66000070007,臺中市,南屯區,文山里,2560,689,2035,2241,525,-1552,25.799,-69.255
66000070023,臺中市,南屯區,寶山里,1140,311,1029,1028,111,-717,10.787,-69.747
66000070008,臺中市,南屯區,新生里,783,176,420,489,363,-313,86.429,-64.008
66000070009,臺中市,南屯區,永定里,1284,410,936,1199,348,-789,37.179,-65.805
66000070010,臺中市,南屯區,三厝里,1753,451,1534,1443,219,-992,14.276,-68.746
66000070025,臺中市,南屯區,三義里,1669,361,1597,1309,72,-948,4.508,-72.422
66000070024,臺中市,南屯區,三和里,2186,448,2101,1675,85,-1227,4.046,-73.254
66000070013,臺中市,南屯區,黎明里,1121,275,1147,804,-26,-529,-2.267,-65.796
66000070011,臺中市,南屯區,溝墘里,1450,400,1353,1274,97,-874,7.169,-68.603
66000070021,臺中市,南屯區,大業里,1648,425,1557,1464,91,-1039,5.845,-70.97
66000070022,臺中市,南屯區,惠中里,1906,510,1718,1663,188,-1153,10.943,-69.333
66000070012,臺中市,南屯區,田心里,1592,488,1281,1469,311,-981,24.278,-66.78
66000070018,臺中市,南屯區,向心里,1207,307,1095,1067,112,-760,10.228,-71.228
66000070016,臺中市,南屯區,文心里,1018,242,896,825,122,-583,13.616,-70.667
66000070017,臺中市,南屯區,同心里,1152,290,1150,1088,2,-798,0.174,-73.346
66000070015,臺中市,南屯區,大同里,1117,358,1069,1199,48,-841,4.49,-70.142
66000070020,臺中市,南屯區,大興里,1016,345,939,1056,77,-711,8.2,-67.33
66000070019,臺中市,南屯區,大誠里,945,298,805,832,140,-534,17.391,-64.183
66000080003,臺中市,北屯區,三光里,1855,452,1629,1404,226,-952,13.874,-67.806
66000080041,臺中市,北屯區,三和里,1458,383,1369,1110,89,-727,6.501,-65.495
66000080014,臺中市,北屯區,大坑里,478,134,420,487,58,-353,13.81,-72.485
66000080031,臺中市,北屯區,大德里,1321,288,1307,950,14,-662,1.071,-69.684
66000080017,臺中市,北屯區,仁和里,1944,534,1812,1692,132,-1158,7.285,-68.44
66000080018,臺中市,北屯區,仁美里,2314,596,1995,2001,319,-1405,15.99,-70.215
66000080022,臺中市,北屯區,仁愛里,271,68,286,191,-15,-123,-5.245,-64.398
66000080008,臺中市,北屯區,水景里,3352,876,2867,3037,485,-2161,16.917,-71.156
66000080023,臺中市,北屯區,水湳里,1705,531,1523,1447,182,-916,11.95,-63.303
66000080002,臺中市,北屯區,北屯里,857,206,820,649,37,-443,4.512,-68.259
66000080034,臺中市,北屯區,北京里,674,209,687,766,-13,-557,-1.892,-72.715
66000080001,臺中市,北屯區,北興里,819,234,721,701,98,-467,13.592,-66.619
66000080019,臺中市,北屯區,四民里,568,179,324,365,244,-186,75.309,-50.959
66000080035,臺中市,北屯區,平心里,1177,295,1063,956,114,-661,10.724,-69.142
66000080004,臺中市,北屯區,平田里,1380,331,1272,1125,108,-794,8.491,-70.578
66000080026,臺中市,北屯區,平安里,1219,385,1174,1177,45,-792,3.833,-67.29
66000080005,臺中市,北屯區,平和里,1252,279,1146,947,106,-668,9.25,-70.539
66000080040,臺中市,北屯區,平昌里,1059,264,974,894,85,-630,8.727,-70.47
66000080038,臺中市,北屯區,平陽里,1117,280,1087,977,30,-697,2.76,-71.341
66000080027,臺中市,北屯區,平順里,699,195,700,694,-1,-499,-0.143,-71.902
66000080036,臺中市,北屯區,平福里,977,223,894,709,83,-486,9.284,-68.547
66000080028,臺中市,北屯區,平德里,1362,384,1355,1260,7,-876,0.517,-69.524
66000080039,臺中市,北屯區,平興里,1645,428,1433,1298,212,-870,14.794,-67.026
66000080012,臺中市,北屯區,民政里,200,50,174,200,26,-150,14.943,-75.0
66000080015,臺中市,北屯區,民德里,205,58,163,193,42,-135,25.767,-69.948
66000080021,臺中市,北屯區,同榮里,1407,327,1247,1153,160,-826,12.831,-71.639
66000080020,臺中市,北屯區,后庄里,2791,523,2537,1785,254,-1262,10.012,-70.7
66000080010,臺中市,北屯區,和平里,2844,740,2329,2421,515,-1681,22.112,-69.434
66000080042,臺中市,北屯區,忠平里,1077,196,1008,695,69,-499,6.845,-71.799
66000080011,臺中市,北屯區,東山里,414,171,366,553,48,-382,13.115,-69.078
66000080006,臺中市,北屯區,東光里,1082,284,996,949,86,-665,8.635,-70.074
66000080029,臺中市,北屯區,松安里,1175,303,1025,1029,150,-726,14.634,-70.554
66000080016,臺中市,北屯區,松竹里,2146,453,2140,1731,6,-1278,0.28,-73.83
66000080037,臺中市,北屯區,松和里,1451,401,1299,1179,152,-778,11.701,-65.988
66000080033,臺中市,北屯區,松勇里,1414,346,1181,1064,233,-718,19.729,-67.481
66000080030,臺中市,北屯區,松茂里,1382,318,1254,994,128,-676,10.207,-68.008
66000080032,臺中市,北屯區,松強里,1544,360,1385,1341,159,-981,11.48,-73.154
66000080009,臺中市,北屯區,軍功里,3014,836,2518,2913,496,-2077,19.698,-71.301
66000080024,臺中市,北屯區,陳平里,1209,282,1085,839,124,-557,11.429,-66.389
66000080025,臺中市,北屯區,新平里,1157,217,999,747,158,-530,15.816,-70.95
66000080013,臺中市,北屯區,廍子里,4594,1008,2833,2619,1761,-1611,62.16,-61.512
66000080007,臺中市,北屯區,舊社里,3477,925,1467,1465,2010,-540,137.014,-36.86
66000050026,臺中市,北區,中正里,235,116,218,356,17,-240,7.798,-67.416
66000050027,臺中市,北區,六合里,334,146,260,414,74,-268,28.462,-64.734
66000050001,臺中市,北區,光大里,448,127,373,465,75,-338,20.107,-72.688
66000050002,臺中市,北區,文莊里,1002,214,1010,609,-8,-395,-0.792,-64.86
66000050028,臺中市,北區,大湖里,339,122,323,494,16,-372,4.954,-75.304
66000050003,臺中市,北區,五常里,263,101,233,327,30,-226,12.876,-69.113
66000050029,臺中市,北區,錦平里,343,157,377,404,-34,-247,-9.019,-61.139
66000050005,臺中市,北區,新北里,339,116,373,402,-34,-286,-9.115,-71.144
66000050004,臺中市,北區,新興里,355,78,351,264,4,-186,1.14,-70.455
66000050006,臺中市,北區,樂英里,878,93,887,265,-9,-172,-1.015,-64.906
66000050007,臺中市,北區,錦村里,831,245,786,722,45,-477,5.725,-66.066
66000050008,臺中市,北區,建成里,1358,372,1124,1177,234,-805,20.819,-68.394
66000050030,臺中市,北區,建德里,850,283,801,754,49,-471,6.117,-62.467
66000050009,臺中市,北區,錦洲里,849,217,807,644,42,-427,5.204,-66.304
66000050020,臺中市,北區,錦祥里,1403,316,1078,888,325,-572,30.148,-64.414
66000050010,臺中市,北區,金華里,712,159,640,536,72,-377,11.25,-70.336
66000050011,臺中市,北區,金龍里,1124,357,977,863,147,-506,15.046,-58.633
66000050012,臺中市,北區,邱厝里,515,149,510,485,5,-336,0.98,-69.278
66000050013,臺中市,北區,建興里,1246,419,1182,1270,64,-851,5.415,-67.008
66000050014,臺中市,北區,頂厝里,990,257,990,879,0,-622,0.0,-70.762
66000050031,臺中市,北區,崇德里,787,234,713,725,74,-491,10.379,-67.724
66000050015,臺中市,北區,賴厝里,974,244,972,744,2,-500,0.206,-67.204
66000050036,臺中市,北區,賴福里,917,309,953,879,-36,-570,-3.778,-64.846
66000050025,臺中市,北區,賴興里,985,244,940,705,45,-461,4.787,-65.39
66000050032,臺中市,北區,賴旺里,910,235,858,792,52,-557,6.061,-70.328
66000050024,臺中市,北區,賴明里,963,248,867,711,96,-463,11.073,-65.12
66000050035,臺中市,北區,梅川里,735,212,714,684,21,-472,2.941,-69.006
66000050016,臺中市,北區,賴村里,1006,379,889,1040,117,-661,13.161,-63.558
66000050017,臺中市,北區,育德里,905,264,849,809,56,-545,6.596,-67.367
66000050018,臺中市,北區,淡溝里,1182,390,1102,1156,80,-766,7.26,-66.263
66000050021,臺中市,北區,健行里,1580,530,1398,1649,182,-1119,13.019,-67.859
66000050022,臺中市,北區,明德里,1256,346,1136,1186,120,-840,10.563,-70.826
66000050033,臺中市,北區,明新里,682,202,603,558,79,-356,13.101,-63.799
66000050023,臺中市,北區,長青里,1360,391,1271,1297,89,-906,7.002,-69.854
66000050034,臺中市,北區,立人里,883,236,847,702,36,-466,4.25,-66.382
66000050019,臺中市,北區,中達里,567,205,557,580,10,-375,1.795,-64.655
66000040003,臺中市,西區,三民里,352,144,415,388,-63,-244,-15.181,-62.887
66000040002,臺中市,西區,利民里,343,91,349,273,-6,-182,-1.719,-66.667
66000040001,臺中市,西區,民生里,362,126,390,409,-28,-283,-7.179,-69.193
66000040005,臺中市,西區,廣民里,301,97,299,310,2,-213,0.669,-68.71
66000040006,臺中市,西區,平和里,428,125,415,392,13,-267,3.133,-68.112
66000040004,臺中市,西區,東昇里,490,166,534,563,-44,-397,-8.24,-70.515
66000040007,臺中市,西區,公民里,1111,375,1094,1154,17,-779,1.554,-67.504
66000040008,臺中市,西區,藍興里,1002,365,906,929,96,-564,10.596,-60.71
66000040009,臺中市,西區,公舘里,1211,402,1158,1357,53,-955,4.577,-70.376
66000040013,臺中市,西區,安龍里,635,275,640,731,-5,-456,-0.781,-62.38
66000040014,臺中市,西區,吉龍里,1551,424,1516,1447,35,-1023,2.309,-70.698
66000040018,臺中市,西區,土庫里,1244,395,1163,1406,81,-1011,6.965,-71.906
66000040025,臺中市,西區,大忠里,1129,321,1077,1052,52,-731,4.828,-69.487
66000040011,臺中市,西區,民龍里,908,263,782,729,126,-466,16.113,-63.923
66000040010,臺中市,西區,和龍里,494,195,425,561,69,-366,16.235,-65.241
66000040012,臺中市,西區,後龍里,779,300,708,779,71,-479,10.028,-61.489
66000040024,臺中市,西區,双龍里,609,193,631,608,-22,-415,-3.487,-68.257
66000040015,臺中市,西區,昇平里,1233,406,1172,1341,61,-935,5.205,-69.724
66000040021,臺中市,西區,中興里,794,331,718,996,76,-665,10.585,-66.767
66000040020,臺中市,西區,公益里,628,235,551,711,77,-476,13.975,-66.948
66000040023,臺中市,西區,公德里,1026,299,929,940,97,-641,10.441,-68.191
66000040017,臺中市,西區,公正里,1507,456,1428,1483,79,-1027,5.532,-69.252
66000040022,臺中市,西區,公平里,1157,353,1114,1004,43,-651,3.86,-64.841
66000040016,臺中市,西區,忠明里,1329,434,1288,1393,41,-959,3.183,-68.844
66000040019,臺中市,西區,忠誠里,1196,433,1178,1300,18,-867,1.528,-66.692
66000010003,臺中市,中區,綠川里,281,114,292,388,-11,-274,-3.767,-70.619
66000010001,臺中市,中區,繼光里,238,117,267,374,-29,-257,-10.861,-68.717
66000010004,臺中市,中區,公園里,254,124,265,313,-11,-189,-4.151,-60.383
66000010005,臺中市,中區,光復里,362,124,411,437,-49,-313,-11.922,-71.625
66000010002,臺中市,中區,大墩里,377,138,377,448,0,-310,0.0,-69.196
66000010006,臺中市,中區,柳川里,349,119,329,375,20,-256,6.079,-68.267
66000010007,臺中市,中區,大誠里,510,183,451,539,59,-356,13.082,-66.048
66000010008,臺中市,中區,中華里,412,124,373,390,39,-266,10.456,-68.205
66000020001,臺中市,東區,新庄里,517,200,510,657,7,-457,1.373,-69.559
66000020002,臺中市,東區,振興里,607,252,569,855,38,-603,6.678,-70.526
66000020003,臺中市,東區,東橋里,709,324,620,1076,89,-752,14.355,-69.888
66000020004,臺中市,東區,東興里,603,246,517,723,86,-477,16.634,-65.975
66000020006,臺中市,東區,泉源里,464,175,403,521,61,-346,15.136,-66.411
66000020005,臺中市,東區,干城里,554,215,409,501,145,-286,35.452,-57.086
66000020007,臺中市,東區,旱溪里,585,204,534,645,51,-441,9.551,-68.372
66000020008,臺中市,東區,樂成里,540,209,395,569,145,-360,36.709,-63.269
66000020009,臺中市,東區,東門里,1593,594,1213,1813,380,-1219,31.327,-67.237
66000020010,臺中市,東區,十甲里,1136,354,969,1119,167,-765,17.234,-68.365
66000020017,臺中市,東區,東英里,1800,519,1443,1757,357,-1238,24.74,-70.461
66000020011,臺中市,東區,東南里,964,238,849,802,115,-564,13.545,-70.324
66000020012,臺中市,東區,東勢里,569,170,560,517,9,-347,1.607,-67.118
66000020013,臺中市,東區,合作里,1068,180,1049,624,19,-444,1.811,-71.154
66000020015,臺中市,東區,富仁里,1240,212,1242,602,-2,-390,-0.161,-64.784
66000020014,臺中市,東區,富台里,517,90,495,267,22,-177,4.444,-66.292
66000020016,臺中市,東區,東信里,2104,671,1656,2334,448,-1663,27.053,-71.251
66000030015,臺中市,南區,長春里,396,162,407,486,-11,-324,-2.703,-66.667
66000030016,臺中市,南區,長榮里,605,186,549,607,56,-421,10.2,-69.357
66000030001,臺中市,南區,城隍里,804,281,736,869,68,-588,9.239,-67.664
66000030002,臺中市,南區,國光里,796,303,731,947,65,-644,8.892,-68.004
66000030003,臺中市,南區,南門里,811,328,763,863,48,-535,6.291,-61.993
66000030004,臺中市,南區,德義里,702,202,681,665,21,-463,3.084,-69.624
66000030005,臺中市,南區,積善里,592,202,518,633,74,-431,14.286,-68.088
66000030006,臺中市,南區,江川里,689,228,660,671,29,-443,4.394,-66.021
66000030007,臺中市,南區,新榮里,1232,325,1005,897,227,-572,22.587,-63.768
66000030008,臺中市,南區,福興里,865,320,891,925,-26,-605,-2.918,-65.405
66000030009,臺中市,南區,福平里,1165,383,1096,1220,69,-837,6.296,-68.607
66000030017,臺中市,南區,福順里,1372,389,1208,1206,164,-817,13.576,-67.745
66000030010,臺中市,南區,和平里,920,246,756,797,164,-551,21.693,-69.134
66000030018,臺中市,南區,平和里,732,221,675,829,57,-608,8.444,-73.341
66000030019,臺中市,南區,南和里,1759,440,1565,1415,194,-975,12.396,-68.905
66000030011,臺中市,南區,永興里,2023,533,1791,1722,232,-1189,12.954,-69.048
66000030020,臺中市,南區,永和里,1025,280,976,971,49,-691,5.02,-71.164
66000030012,臺中市,南區,樹義里,3088,755,2449,2606,639,-1851,26.092,-71.028
66000030021,臺中市,南區,工學里,1728,414,1463,1385,265,-971,18.113,-70.108
66000030013,臺中市,南區,樹德里,2474,567,1954,1795,520,-1228,26.612,-68.412
66000030014,臺中市,南區,西川里,1056,317,992,910,64,-593,6.452,-65.165
66000030022,臺中市,南區,崇倫里,1382,450,1167,1275,215,-825,18.423,-64.706
66000270001,臺中市,太平區,太平里,1075,322,937,1233,138,-911,14.728,-73.885
66000270002,臺中市,太平區,長億里,1592,381,1174,1230,418,-849,35.605,-69.024
66000270020,臺中市,太平區,永成里,1535,398,1156,1372,379,-974,32.785,-70.991
66000270003,臺中市,太平區,中平里,885,255,714,878,171,-623,23.95,-70.957
66000270024,臺中市,太平區,中政里,744,205,606,783,138,-578,22.772,-73.819
66000270025,臺中市,太平區,平安里,475,124,367,501,108,-377,29.428,-75.25
66000270004,臺中市,太平區,中興里,675,215,560,765,115,-550,20.536,-71.895
66000270021,臺中市,太平區,永平里,838,239,682,852,156,-613,22.874,-71.948
66000270006,臺中市,太平區,東平里,871,225,684,848,187,-623,27.339,-73.467
66000270022,臺中市,太平區,成功里,759,246,590,863,169,-617,28.644,-71.495
66000270023,臺中市,太平區,東和里,632,156,475,546,157,-390,33.053,-71.429
66000270005,臺中市,太平區,建國里,612,169,533,590,79,-421,14.822,-71.356
66000270026,臺中市,太平區,建興里,583,156,465,537,118,-381,25.376,-70.95
66000270009,臺中市,太平區,坪林里,842,222,815,625,27,-403,3.313,-64.48
66000270035,臺中市,太平區,大興里,482,121,451,479,31,-358,6.874,-74.739
66000270036,臺中市,太平區,勤益里,605,127,531,366,74,-239,13.936,-65.301
66000270010,臺中市,太平區,光華里,1262,294,1135,944,127,-650,11.189,-68.856
66000270033,臺中市,太平區,光明里,941,198,862,634,79,-436,9.165,-68.77
66000270008,臺中市,太平區,中山里,756,194,715,556,41,-362,5.734,-65.108
66000270034,臺中市,太平區,豐年里,1088,257,1025,880,63,-623,6.146,-70.795
66000270007,臺中市,太平區,宜欣里,1342,355,1035,1276,307,-921,29.662,-72.179
66000270031,臺中市,太平區,宜佳里,1389,319,1177,1124,212,-805,18.012,-71.619
66000270032,臺中市,太平區,宜昌里,932,282,616,778,316,-496,51.299,-63.753
66000270011,臺中市,太平區,新坪里,1843,450,1457,1311,386,-861,26.493,-65.675
66000270029,臺中市,太平區,新吉里,1350,360,1154,1049,196,-689,16.984,-65.682
66000270030,臺中市,太平區,新城里,1480,375,1008,928,472,-553,46.825,-59.591
66000270012,臺中市,太平區,新光里,1707,462,1470,1611,237,-1149,16.122,-71.322
66000270027,臺中市,太平區,新興里,1553,347,1078,1172,475,-825,44.063,-70.392
66000270028,臺中市,太平區,新高里,2433,597,1642,1597,791,-1000,48.173,-62.617
66000270013,臺中市,太平區,新福里,1731,446,1364,1370,367,-924,26.906,-67.445
66000270014,臺中市,太平區,頭汴里,318,84,318,339,0,-255,0.0,-75.221
66000270037,臺中市,太平區,聖和里,297,86,261,323,36,-237,13.793,-73.375
66000270015,臺中市,太平區,東汴里,182,47,166,235,16,-188,9.639,-80.0
66000270016,臺中市,太平區,興隆里,691,176,586,597,105,-421,17.918,-70.519
66000270038,臺中市,太平區,福隆里,842,236,672,779,170,-543,25.298,-69.705
66000270019,臺中市,太平區,黃竹里,105,20,102,146,3,-126,2.941,-86.301
66000270017,臺中市,太平區,光隆里,571,218,424,761,147,-543,34.67,-71.353
66000270039,臺中市,太平區,永隆里,466,132,397,497,69,-365,17.38,-73.441
66000270018,臺中市,太平區,德隆里,978,284,751,1023,227,-739,30.226,-72.239
66000280019,臺中市,大里區,東湖里,2371,702,1829,2189,542,-1487,29.634,-67.931
66000280020,臺中市,大里區,西湖里,618,210,498,670,120,-460,24.096,-68.657
66000280001,臺中市,大里區,大里里,807,287,697,836,110,-549,15.782,-65.67
66000280002,臺中市,大里區,新里里,2273,681,1971,2264,302,-1583,15.322,-69.92
66000280021,臺中市,大里區,國光里,1428,326,1276,1176,152,-850,11.912,-72.279
66000280003,臺中市,大里區,樹王里,744,309,599,958,145,-649,24.207,-67.745
66000280005,臺中市,大里區,祥興里,1649,587,1360,1731,289,-1144,21.25,-66.089
66000280008,臺中市,大里區,內新里,1966,532,1700,1679,266,-1147,15.647,-68.314
66000280025,臺中市,大里區,中新里,1235,296,1049,1070,186,-774,17.731,-72.336
66000280009,臺中市,大里區,東昇里,705,204,660,749,45,-545,6.818,-72.764
66000280012,臺中市,大里區,大元里,907,346,812,1064,95,-718,11.7,-67.481
66000280013,臺中市,大里區,夏田里,208,93,167,298,41,-205,24.551,-68.792
66000280014,臺中市,大里區,仁化里,1669,474,1346,1775,323,-1301,23.997,-73.296
66000280027,臺中市,大里區,仁德里,1242,354,1037,1272,205,-918,19.769,-72.17
66000280015,臺中市,大里區,健民里,1008,318,748,953,260,-635,34.759,-66.632
66000280016,臺中市,大里區,塗城里,1701,562,1374,1823,327,-1261,23.799,-69.172
66000280004,臺中市,大里區,東興里,1445,500,1320,1586,125,-1086,9.47,-68.474
66000280022,臺中市,大里區,大明里,969,309,779,896,190,-587,24.39,-65.513
66000280023,臺中市,大里區,永隆里,2433,648,2241,2170,192,-1522,8.568,-70.138
66000280006,臺中市,大里區,日新里,1111,334,889,931,222,-597,24.972,-64.125
66000280007,臺中市,大里區,西榮里,1119,389,1000,1198,119,-809,11.9,-67.529
66000280024,臺中市,大里區,長榮里,2026,566,1889,1911,137,-1345,7.253,-70.382
66000280018,臺中市,大里區,金城里,2128,582,1742,2003,386,-1421,22.158,-70.944
66000280010,臺中市,大里區,立仁里,1093,315,858,1112,235,-797,27.389,-71.673
66000280026,臺中市,大里區,立德里,1771,493,1382,1638,389,-1145,28.148,-69.902
66000280011,臺中市,大里區,新仁里,1798,580,1424,1803,374,-1223,26.264,-67.831
66000280017,臺中市,大里區,瑞城里,2655,773,2117,2375,538,-1602,25.413,-67.453
66000090001,臺中市,豐原區,豐原里,829,298,517,467,312,-169,60.348,-36.188
66000090004,臺中市,豐原區,豐榮里,332,188,204,310,128,-122,62.745,-39.355
66000090002,臺中市,豐原區,頂街里,281,177,169,253,112,-76,66.272,-30.04
66000090003,臺中市,豐原區,中山里,246,166,171,231,75,-65,43.86,-28.139
66000090005,臺中市,豐原區,下街里,252,131,127,171,125,-40,98.425,-23.392
66000090028,臺中市,豐原區,中陽里,1891,858,1079,1182,812,-324,75.255,-27.411
66000090013,臺中市,豐原區,大湳里,856,360,474,626,382,-266,80.591,-42.492
66000090014,臺中市,豐原區,北湳里,1072,460,644,637,428,-177,66.46,-27.786
66000090015,臺中市,豐原區,東湳里,1250,640,616,1048,634,-408,102.922,-38.931
66000090016,臺中市,豐原區,西湳里,3125,1392,1581,2250,1544,-858,97.66,-38.133
66000090008,臺中市,豐原區,豐西里,563,253,355,401,208,-148,58.592,-36.908
66000090017,臺中市,豐原區,圳寮里,431,221,246,345,185,-124,75.203,-35.942
66000090018,臺中市,豐原區,豐圳里,1186,500,734,763,452,-263,61.58,-34.469
66000090006,臺中市,豐原區,富春里,210,160,150,234,60,-74,40.0,-31.624
66000090007,臺中市,豐原區,葫蘆里,179,117,121,180,58,-63,47.934,-35.0
66000090009,臺中市,豐原區,西安里,1572,738,996,1180,576,-442,57.831,-37.458
66000090010,臺中市,豐原區,西勢里,716,337,473,575,243,-238,51.374,-41.391
66000090021,臺中市,豐原區,中興里,1021,360,676,555,345,-195,51.036,-35.135
66000090019,臺中市,豐原區,社皮里,3332,1304,1812,2085,1520,-781,83.885,-37.458
66000090020,臺中市,豐原區,三村里,2190,987,1254,1538,936,-551,74.641,-35.826
66000090011,臺中市,豐原區,東勢里,442,236,286,377,156,-141,54.545,-37.401
66000090012,臺中市,豐原區,民生里,346,189,184,285,162,-96,88.043,-33.684
66000090022,臺中市,豐原區,田心里,1939,881,1141,1347,798,-466,69.939,-34.595
66000090023,臺中市,豐原區,豐田里,3392,1481,1866,2396,1526,-915,81.779,-38.189
66000090024,臺中市,豐原區,鎌村里,1622,637,902,1098,720,-461,79.823,-41.985
66000090026,臺中市,豐原區,陽明里,907,430,548,612,359,-182,65.511,-29.739
66000090025,臺中市,豐原區,南陽里,3593,1438,2072,2325,1521,-887,73.407,-38.151
66000090027,臺中市,豐原區,北陽里,4526,1942,2545,2898,1981,-956,77.839,-32.988
66000090029,臺中市,豐原區,東陽里,472,280,287,440,185,-160,64.46,-36.364
66000090030,臺中市,豐原區,南村里,1798,853,997,1324,801,-471,80.341,-35.574
66000090031,臺中市,豐原區,南田里,1018,518,576,816,442,-298,76.736,-36.52
66000090032,臺中市,豐原區,南嵩里,1090,533,592,850,498,-317,84.122,-37.294
66000090033,臺中市,豐原區,翁明里,823,302,490,486,333,-184,67.959,-37.86
66000090034,臺中市,豐原區,翁子里,1218,459,619,712,599,-253,96.769,-35.534
66000090035,臺中市,豐原區,翁社里,755,330,418,538,337,-208,80.622,-38.662
66000090036,臺中市,豐原區,朴子里,1071,510,530,827,541,-317,102.075,-38.331
66000200001,臺中市,石岡區,石岡里,390,158,222,218,168,-60,75.676,-27.523
66000200002,臺中市,石岡區,萬安里,525,198,324,324,201,-126,62.037,-38.889
66000200003,臺中市,石岡區,九房里,432,160,263,258,169,-98,64.259,-37.984
66000200004,臺中市,石岡區,金星里,386,161,220,241,166,-80,75.455,-33.195
66000200005,臺中市,石岡區,龍興里,194,73,127,134,67,-61,52.756,-45.522
66000200006,臺中市,石岡區,萬興里,526,174,318,303,208,-129,65.409,-42.574
66000200007,臺中市,石岡區,梅子里,618,229,393,361,225,-132,57.252,-36.565
66000200008,臺中市,石岡區,土牛里,349,147,232,182,117,-35,50.431,-19.231
66000200009,臺中市,石岡區,德興里,518,162,329,244,189,-82,57.447,-33.607
66000200010,臺中市,石岡區,和盛里,434,141,316,214,118,-73,37.342,-34.112
66000190001,臺中市,新社區,新社里,1214,378,731,638,483,-260,66.074,-40.752
66000190002,臺中市,新社區,復盛里,538,186,330,272,208,-86,63.03,-31.618
66000190003,臺中市,新社區,中正里,490,160,271,267,219,-107,80.812,-40.075
66000190004,臺中市,新社區,月湖里,300,145,162,218,138,-73,85.185,-33.486
66000190005,臺中市,新社區,崑山里,282,142,160,308,122,-166,76.25,-53.896
66000190006,臺中市,新社區,大南里,627,220,366,359,261,-139,71.311,-38.719
66000190007,臺中市,新社區,永源里,890,400,448,711,442,-311,98.661,-43.741
66000190008,臺中市,新社區,中興里,249,62,198,67,51,-5,25.758,-7.463
66000190009,臺中市,新社區,協成里,904,356,506,595,398,-239,78.656,-40.168
66000190010,臺中市,新社區,東興里,429,132,288,198,141,-66,48.958,-33.333
66000190011,臺中市,新社區,慶西里,263,117,123,193,140,-76,113.821,-39.378
66000190012,臺中市,新社區,中和里,232,55,169,52,63,3,37.278,5.769
66000190013,臺中市,新社區,福興里,383,129,229,187,154,-58,67.249,-31.016
66000100017,臺中市,東勢區,慶福里,339,131,195,180,144,-49,73.846,-27.222
66000100016,臺中市,東勢區,慶東里,600,230,315,380,285,-150,90.476,-39.474
66000100014,臺中市,東勢區,上城里,367,160,228,199,139,-39,60.965,-19.598
66000100015,臺中市,東勢區,下城里,280,122,178,189,102,-67,57.303,-35.45
66000100013,臺中市,東勢區,詒福里,530,192,333,332,197,-140,59.159,-42.169
66000100012,臺中市,東勢區,新盛里,1871,652,986,902,885,-250,89.757,-27.716
66000100010,臺中市,東勢區,福隆里,1435,437,841,622,594,-185,70.63,-29.743
66000100011,臺中市,東勢區,隆興里,466,158,271,216,195,-58,71.956,-26.852
66000100009,臺中市,東勢區,中嵙里,682,212,384,283,298,-71,77.604,-25.088
66000100008,臺中市,東勢區,泰昌里,1240,337,917,527,323,-190,35.224,-36.053
66000100006,臺中市,東勢區,上新里,375,111,262,162,113,-51,43.13,-31.481
66000100007,臺中市,東勢區,廣興里,509,170,332,238,177,-68,53.313,-28.571
66000100005,臺中市,東勢區,延平里,692,267,501,409,191,-142,38.124,-34.719
66000100004,臺中市,東勢區,南平里,707,183,517,287,190,-104,36.75,-36.237
66000100003,臺中市,東勢區,東安里,385,106,257,173,128,-67,49.805,-38.728
66000100002,臺中市,東勢區,中寧里,313,80,235,129,78,-49,33.191,-37.984
66000100001,臺中市,東勢區,北興里,523,146,298,194,225,-48,75.503,-24.742
66000100019,臺中市,東勢區,粵寧里,720,223,461,378,259,-155,56.182,-41.005
66000100020,臺中市,東勢區,下新里,562,195,329,327,233,-132,70.821,-40.367
66000100018,臺中市,東勢區,東新里,753,253,521,333,232,-80,44.53,-24.024
66000100021,臺中市,東勢區,興隆里,341,153,215,242,126,-89,58.605,-36.777
66000100022,臺中市,東勢區,茂興里,662,193,339,279,323,-86,95.28,-30.824
66000100023,臺中市,東勢區,泰興里,229,103,121,105,108,-2,89.256,-1.905
66000100024,臺中市,東勢區,埤頭里,219,101,107,178,112,-77,104.673,-43.258
66000100025,臺中市,東勢區,明正里,392,168,206,256,186,-88,90.291,-34.375
66000290001,臺中市,和平區,南勢里,586,144,420,226,166,-82,39.524,-36.283
66000290002,臺中市,和平區,天輪里,132,38,77,64,55,-26,71.429,-40.625
66000290003,臺中市,和平區,博愛里,445,97,382,147,63,-50,16.492,-34.014
66000290005,臺中市,和平區,自由里,382,57,317,98,65,-41,20.505,-41.837
66000290006,臺中市,和平區,達觀里,386,81,300,120,86,-39,28.667,-32.5
66000290004,臺中市,和平區,中坑里,174,39,134,59,40,-20,29.851,-33.898
66000290007,臺中市,和平區,梨山里,366,69,268,159,98,-90,36.567,-56.604
66000290008,臺中市,和平區,平等里,229,13,156,53,73,-40,46.795,-75.472
10016010002,澎湖縣,馬公市,復興里,67,21,81,56,-14,-35,-17.284,-62.5
10016010003,澎湖縣,馬公市,長安里,97,35,121,96,-24,-61,-19.835,-63.542
10016010004,澎湖縣,馬公市,中央里,83,28,94,104,-11,-76,-11.702,-73.077
10016010005,澎湖縣,馬公市,啟明里,142,66,145,189,-3,-123,-2.069,-65.079
10016010006,澎湖縣,馬公市,重慶里,122,80,162,213,-40,-133,-24.691,-62.441
10016010007,澎湖縣,馬公市,中興里,131,39,156,114,-25,-75,-16.026,-65.789
10016010008,澎湖縣,馬公市,光復里,293,100,321,326,-28,-226,-8.723,-69.325
10016010010,澎湖縣,馬公市,光明里,176,49,245,166,-69,-117,-28.163,-70.482
10016010009,澎湖縣,馬公市,光榮里,845,140,960,520,-115,-380,-11.979,-73.077
10016010011,澎湖縣,馬公市,朝陽里,871,224,911,755,-40,-531,-4.391,-70.331
10016010012,澎湖縣,馬公市,陽明里,381,108,389,376,-8,-268,-2.057,-71.277
10016010013,澎湖縣,馬公市,重光里,284,75,252,257,32,-182,12.698,-70.817
10016010014,澎湖縣,馬公市,西衛里,932,234,1019,758,-87,-524,-8.538,-69.129
10016010015,澎湖縣,馬公市,西文里,526,139,544,453,-18,-314,-3.309,-69.316
10016010016,澎湖縣,馬公市,東文里,615,140,534,453,81,-313,15.169,-69.095
10016010017,澎湖縣,馬公市,案山里,260,86,293,265,-33,-179,-11.263,-67.547
10016010018,澎湖縣,馬公市,光華里,159,30,136,85,23,-55,16.912,-64.706
10016010019,澎湖縣,馬公市,前寮里,162,42,128,161,34,-119,26.562,-73.913
10016010020,澎湖縣,馬公市,石泉里,541,112,508,371,33,-259,6.496,-69.811
10016010021,澎湖縣,馬公市,菜園里,75,19,71,74,4,-55,5.634,-74.324
10016010022,澎湖縣,馬公市,東衛里,402,67,409,263,-7,-196,-1.711,-74.525
10016010023,澎湖縣,馬公市,安宅里,112,38,107,92,5,-54,4.673,-58.696
10016010025,澎湖縣,馬公市,興仁里,242,53,210,175,32,-122,15.238,-69.714
10016010024,澎湖縣,馬公市,烏崁里,169,67,123,234,46,-167,37.398,-71.368
10016010026,澎湖縣,馬公市,鐵線里,105,53,71,158,34,-105,47.887,-66.456
10016010028,澎湖縣,馬公市,鎖港里,304,133,242,521,62,-388,25.62,-74.472
10016010027,澎湖縣,馬公市,山水里,206,118,194,319,12,-201,6.186,-63.009
10016010029,澎湖縣,馬公市,五德里,65,9,54,43,11,-34,20.37,-79.07
10016010030,澎湖縣,馬公市,井垵里,48,14,55,59,-7,-45,-12.727,-76.271
10016010031,澎湖縣,馬公市,嵵裡里,146,29,182,121,-36,-92,-19.78,-76.033
10016010032,澎湖縣,馬公市,風櫃里,121,78,105,280,16,-202,15.238,-72.143
10016010033,澎湖縣,馬公市,虎井里,60,18,80,52,-20,-34,-25.0,-65.385
10016010034,澎湖縣,馬公市,桶盤里,27,7,23,20,4,-13,17.391,-65.0
10016020001,澎湖縣,湖西鄉,湖西村,214,64,197,168,17,-104,8.629,-61.905
10016020002,澎湖縣,湖西鄉,湖東村,56,22,45,53,11,-31,24.444,-58.491
10016020003,澎湖縣,湖西鄉,青螺村,40,10,36,30,4,-20,11.111,-66.667
10016020004,澎湖縣,湖西鄉,白坑村,37,10,40,46,-3,-36,-7.5,-78.261
10016020005,澎湖縣,湖西鄉,南寮村,61,47,44,137,17,-90,38.636,-65.693
10016020006,澎湖縣,湖西鄉,北寮村,46,14,45,42,1,-28,2.222,-66.667
10016020007,澎湖縣,湖西鄉,紅羅村,77,26,70,147,7,-121,10.0,-82.313
10016020008,澎湖縣,湖西鄉,西溪村,103,27,74,93,29,-66,39.189,-70.968
10016020009,澎湖縣,湖西鄉,成功村,183,49,125,166,58,-117,46.4,-70.482
10016020010,澎湖縣,湖西鄉,東石村,17,14,16,33,1,-19,6.25,-57.576
10016020015,澎湖縣,湖西鄉,沙港村,60,60,61,200,-1,-140,-1.639,-70.0
10016020011,澎湖縣,湖西鄉,中西村,47,4,36,37,11,-33,30.556,-89.189
10016020013,澎湖縣,湖西鄉,鼎灣村,95,22,72,59,23,-37,31.944,-62.712
10016020012,澎湖縣,湖西鄉,潭邊村,49,20,55,53,-6,-33,-10.909,-62.264
10016020014,澎湖縣,湖西鄉,許家村,81,22,55,47,26,-25,47.273,-53.191
10016020016,澎湖縣,湖西鄉,城北村,84,17,74,46,10,-29,13.514,-63.043
10016020017,澎湖縣,湖西鄉,太武村,16,8,14,17,2,-9,14.286,-52.941
10016020018,澎湖縣,湖西鄉,隘門村,158,45,141,141,17,-96,12.057,-68.085
10016020019,澎湖縣,湖西鄉,林投村,112,55,108,188,4,-133,3.704,-70.745
10016020020,澎湖縣,湖西鄉,尖山村,71,44,68,127,3,-83,4.412,-65.354
10016020021,澎湖縣,湖西鄉,龍門村,242,84,245,296,-3,-212,-1.224,-71.622
10016020022,澎湖縣,湖西鄉,菓葉村,75,49,70,158,5,-109,7.143,-68.987
10016030001,澎湖縣,白沙鄉,中屯村,74,22,88,78,-14,-56,-15.909,-71.795
10016030002,澎湖縣,白沙鄉,講美村,95,27,121,86,-26,-59,-21.488,-68.605
10016030003,澎湖縣,白沙鄉,城前村,25,4,32,19,-7,-15,-21.875,-78.947
10016030004,澎湖縣,白沙鄉,鎮海村,33,4,39,8,-6,-4,-15.385,-50.0
10016030005,澎湖縣,白沙鄉,港子村,42,17,41,36,1,-19,2.439,-52.778
10016030006,澎湖縣,白沙鄉,岐頭村,34,7,30,18,4,-11,13.333,-61.111
10016030007,澎湖縣,白沙鄉,小赤村,31,8,32,30,-1,-22,-3.125,-73.333
10016030008,澎湖縣,白沙鄉,赤崁村,229,52,242,223,-13,-171,-5.372,-76.682
10016030009,澎湖縣,白沙鄉,瓦硐村,45,14,45,44,0,-30,0.0,-68.182
10016030010,澎湖縣,白沙鄉,後寮村,72,30,81,132,-9,-102,-11.111,-77.273
10016030011,澎湖縣,白沙鄉,通梁村,83,33,84,119,-1,-86,-1.19,-72.269
10016030012,澎湖縣,白沙鄉,吉貝村,49,59,59,204,-10,-145,-16.949,-71.078
10016030013,澎湖縣,白沙鄉,鳥嶼村,155,25,178,57,-23,-32,-12.921,-56.14
10016030014,澎湖縣,白沙鄉,員貝村,48,4,56,8,-8,-4,-14.286,-50.0
10016030015,澎湖縣,白沙鄉,大倉村,6,18,11,38,-5,-20,-45.455,-52.632
10016040001,澎湖縣,西嶼鄉,橫礁村,19,7,21,35,-2,-28,-9.524,-80.0
10016040002,澎湖縣,西嶼鄉,合界村,35,20,36,63,-1,-43,-2.778,-68.254
10016040004,澎湖縣,西嶼鄉,竹灣村,82,49,83,135,-1,-86,-1.205,-63.704
10016040003,澎湖縣,西嶼鄉,小門村,84,5,64,30,20,-25,31.25,-83.333
10016040005,澎湖縣,西嶼鄉,大池村,82,38,72,117,10,-79,13.889,-67.521
10016040006,澎湖縣,西嶼鄉,二崁村,31,20,14,42,17,-22,121.429,-52.381
10016040007,澎湖縣,西嶼鄉,池東村,86,36,76,103,10,-67,13.158,-65.049
10016040008,澎湖縣,西嶼鄉,池西村,28,13,15,47,13,-34,86.667,-72.34
10016040009,澎湖縣,西嶼鄉,赤馬村,52,33,45,97,7,-64,15.556,-65.979
10016040010,澎湖縣,西嶼鄉,內垵村,116,61,96,227,20,-166,20.833,-73.128
10016040011,澎湖縣,西嶼鄉,外垵村,271,33,337,142,-66,-109,-19.585,-76.761
10016050001,澎湖縣,望安鄉,東安村,61,23,57,74,4,-51,7.018,-68.919
10016050002,澎湖縣,望安鄉,西安村,54,15,52,40,2,-25,3.846,-62.5
10016050003,澎湖縣,望安鄉,中社村,25,10,19,34,6,-24,31.579,-70.588
10016050004,澎湖縣,望安鄉,水垵村,41,24,33,61,8,-37,24.242,-60.656
10016050005,澎湖縣,望安鄉,將軍村,45,24,44,130,1,-106,2.273,-81.538
10016050008,澎湖縣,望安鄉,東吉村,29,20,17,19,12,1,70.588,5.263
10016050006,澎湖縣,望安鄉,東坪村,15,10,10,8,5,2,50.0,25.0
10016050007,澎湖縣,望安鄉,西坪村,4,4,3,5,1,-1,33.333,-20.0
10016050009,澎湖縣,望安鄉,花嶼村,23,8,36,14,-13,-6,-36.111,-42.857
10016060001,澎湖縣,七美鄉,東湖村,18,12,10,12,8,0,80.0,0.0
10016060002,澎湖縣,七美鄉,西湖村,54,11,34,29,20,-18,58.824,-62.069
10016060003,澎湖縣,七美鄉,中和村,57,11,40,29,17,-18,42.5,-62.069
10016060004,澎湖縣,七美鄉,平和村,40,12,27,31,13,-19,48.148,-61.29
10016060005,澎湖縣,七美鄉,海豐村,29,8,22,24,7,-16,31.818,-66.667
10016060006,澎湖縣,七美鄉,南港村,85,17,94,48,-9,-31,-9.574,-64.583
63000010002,臺北市,松山區,莊敬里,1087,263,1077,937,10,-674,0.929,-71.932
63000010003,臺北市,松山區,東榮里,1556,578,1681,1715,-125,-1137,-7.436,-66.297
63000010004,臺北市,松山區,三民里,1415,412,1580,1348,-165,-936,-10.443,-69.436
63000010005,臺北市,松山區,新益里,979,312,984,1005,-5,-693,-0.508,-68.955
63000010006,臺北市,松山區,富錦里,1091,339,1146,1027,-55,-688,-4.799,-66.991
63000010007,臺北市,松山區,新東里,970,293,1106,942,-136,-649,-12.297,-68.896
63000010008,臺北市,松山區,富泰里,988,235,1120,766,-132,-531,-11.786,-69.321
63000010009,臺北市,松山區,介壽里,826,268,890,900,-64,-632,-7.191,-70.222
63000010010,臺北市,松山區,精忠里,852,247,953,828,-101,-581,-10.598,-70.169
63000010011,臺北市,松山區,東光里,1450,403,1689,1342,-239,-939,-14.15,-69.97
63000010012,臺北市,松山區,龍田里,2424,447,2742,1524,-318,-1077,-11.597,-70.669
63000010013,臺北市,松山區,東昌里,399,175,537,635,-138,-460,-25.698,-72.441
63000010014,臺北市,松山區,東勢里,812,338,883,888,-71,-550,-8.041,-61.937
63000010015,臺北市,松山區,中華里,1332,397,1435,1200,-103,-803,-7.178,-66.917
63000010016,臺北市,松山區,民有里,1665,694,1797,1982,-132,-1288,-7.346,-64.985
63000010017,臺北市,松山區,民福里,1537,382,1642,1184,-105,-802,-6.395,-67.736
63000010035,臺北市,松山區,松基里,669,276,715,748,-46,-472,-6.434,-63.102
63000010019,臺北市,松山區,安平里,1498,482,1635,1687,-137,-1205,-8.379,-71.429
63000010020,臺北市,松山區,鵬程里,1150,259,1387,886,-237,-627,-17.087,-70.767
63000010021,臺北市,松山區,自強里,2572,345,2904,1074,-332,-729,-11.433,-67.877
63000010018,臺北市,松山區,慈祐里,1290,482,1272,1469,18,-987,1.415,-67.189
63000010022,臺北市,松山區,吉祥里,1637,479,1810,1560,-173,-1081,-9.558,-69.295
63000010024,臺北市,松山區,新聚里,1436,487,1517,1561,-81,-1074,-5.339,-68.802
63000010025,臺北市,松山區,復盛里,1304,337,1436,1193,-132,-856,-9.192,-71.752
63000010026,臺北市,松山區,中正里,1406,497,1654,1806,-248,-1309,-14.994,-72.481
63000010027,臺北市,松山區,中崙里,764,229,778,792,-14,-563,-1.799,-71.086
63000010028,臺北市,松山區,美仁里,587,237,669,743,-82,-506,-12.257,-68.102
63000010029,臺北市,松山區,吉仁里,616,183,739,741,-123,-558,-16.644,-75.304
63000010030,臺北市,松山區,敦化里,1240,501,1420,1463,-180,-962,-12.676,-65.755
63000010031,臺北市,松山區,復源里,693,186,722,603,-29,-417,-4.017,-69.154
63000010032,臺北市,松山區,復建里,869,253,974,830,-105,-577,-10.78,-69.518
63000010033,臺北市,松山區,復勢里,1113,372,1193,1314,-80,-942,-6.706,-71.689
63000010034,臺北市,松山區,福成里,437,167,496,553,-59,-386,-11.895,-69.801
63000020001,臺北市,信義區,西村里,1268,194,1449,653,-181,-459,-12.491,-70.291
63000020002,臺北市,信義區,正和里,1006,253,1165,800,-159,-547,-13.648,-68.375
63000020003,臺北市,信義區,興隆里,536,116,597,412,-61,-296,-10.218,-71.845
63000020004,臺北市,信義區,中興里,609,178,710,585,-101,-407,-14.225,-69.573
63000020005,臺北市,信義區,新仁里,704,155,793,537,-89,-382,-11.223,-71.136
63000020006,臺北市,信義區,興雅里,938,298,1148,1028,-210,-730,-18.293,-71.012
63000020007,臺北市,信義區,敦厚里,898,241,1068,916,-170,-675,-15.918,-73.69
63000020008,臺北市,信義區,廣居里,1445,367,1664,1383,-219,-1016,-13.161,-73.463
63000020009,臺北市,信義區,安康里,1900,497,2093,1810,-193,-1313,-9.221,-72.541
63000020010,臺北市,信義區,六藝里,593,188,718,699,-125,-511,-17.409,-73.104
63000020011,臺北市,信義區,雅祥里,901,330,970,1048,-69,-718,-7.113,-68.511
63000020012,臺北市,信義區,五常里,738,194,772,704,-34,-510,-4.404,-72.443
63000020013,臺北市,信義區,五全里,930,403,860,1088,70,-685,8.14,-62.96
63000020014,臺北市,信義區,永吉里,570,205,548,866,22,-661,4.015,-76.328
63000020015,臺北市,信義區,長春里,689,219,758,798,-69,-579,-9.103,-72.556
63000020016,臺北市,信義區,四育里,1055,403,1072,1254,-17,-851,-1.586,-67.863
63000020017,臺北市,信義區,四維里,1068,236,1163,958,-95,-722,-8.169,-75.365
63000020018,臺北市,信義區,永春里,870,314,933,981,-63,-667,-6.752,-67.992
63000020019,臺北市,信義區,富台里,1105,195,1069,653,36,-458,3.368,-70.138
63000020020,臺北市,信義區,國業里,1325,363,1517,1305,-192,-942,-12.657,-72.184
63000020021,臺北市,信義區,松隆里,357,94,462,410,-105,-316,-22.727,-77.073
63000020022,臺北市,信義區,松友里,1210,310,1358,1169,-148,-859,-10.898,-73.482
63000020023,臺北市,信義區,松光里,827,227,947,1002,-120,-775,-12.672,-77.345
63000020024,臺北市,信義區,中坡里,830,260,943,922,-113,-662,-11.983,-71.8
63000020025,臺北市,信義區,中行里,1338,437,1458,1601,-120,-1164,-8.23,-72.705
63000020026,臺北市,信義區,大道里,1077,350,1164,1310,-87,-960,-7.474,-73.282
63000020027,臺北市,信義區,大仁里,1407,390,770,750,637,-360,82.727,-48.0
63000020028,臺北市,信義區,景新里,1039,209,1194,845,-155,-636,-12.982,-75.266
63000020029,臺北市,信義區,惠安里,1464,316,1496,1039,-32,-723,-2.139,-69.586
63000020030,臺北市,信義區,三張里,1853,429,1985,1557,-132,-1128,-6.65,-72.447
63000020031,臺北市,信義區,三犁里,1048,244,1131,879,-83,-635,-7.339,-72.241
63000020032,臺北市,信義區,六合里,1471,322,1625,1033,-154,-711,-9.477,-68.829
63000020033,臺北市,信義區,泰和里,1406,359,1530,1200,-124,-841,-8.105,-70.083
63000020034,臺北市,信義區,景聯里,970,224,1044,869,-74,-645,-7.088,-74.223
63000020035,臺北市,信義區,景勤里,678,184,851,627,-173,-443,-20.329,-70.654
63000020036,臺北市,信義區,雙和里,1536,359,1693,1237,-157,-878,-9.273,-70.978
63000020037,臺北市,信義區,嘉興里,618,175,708,614,-90,-439,-12.712,-71.498
63000020038,臺北市,信義區,黎順里,745,167,873,680,-128,-513,-14.662,-75.441
63000020039,臺北市,信義區,黎平里,1550,427,1637,1269,-87,-842,-5.315,-66.351
63000020040,臺北市,信義區,黎忠里,1039,279,1116,874,-77,-595,-6.9,-68.078
63000020041,臺北市,信義區,黎安里,409,82,470,263,-61,-181,-12.979,-68.821
63000030001,臺北市,大安區,德安里,1100,293,1377,916,-277,-623,-20.116,-68.013
63000030002,臺北市,大安區,仁慈里,966,332,1084,1088,-118,-756,-10.886,-69.485
63000030003,臺北市,大安區,和安里,1280,322,1478,1153,-198,-831,-13.396,-72.073
63000030004,臺北市,大安區,民炤里,1432,461,1671,1558,-239,-1097,-14.303,-70.411
63000030005,臺北市,大安區,仁愛里,830,284,1012,898,-182,-614,-17.984,-68.374
63000030006,臺北市,大安區,義村里,1388,294,1578,885,-190,-591,-12.041,-66.78
63000030007,臺北市,大安區,民輝里,1176,395,1404,1304,-228,-909,-16.239,-69.709
63000030008,臺北市,大安區,昌隆里,643,232,669,690,-26,-458,-3.886,-66.377
63000030009,臺北市,大安區,誠安里,753,274,848,818,-95,-544,-11.203,-66.504
63000030010,臺北市,大安區,光武里,1365,450,1508,1338,-143,-888,-9.483,-66.368
63000030011,臺北市,大安區,龍坡里,1097,310,1261,1078,-164,-768,-13.006,-71.243
63000030012,臺北市,大安區,龍泉里,807,324,983,926,-176,-602,-17.904,-65.011
63000030013,臺北市,大安區,古風里,796,256,935,859,-139,-603,-14.866,-70.198
63000030014,臺北市,大安區,古莊里,1369,400,1534,1360,-165,-960,-10.756,-70.588
63000030015,臺北市,大安區,龍安里,1093,343,1235,1205,-142,-862,-11.498,-71.535
63000030016,臺北市,大安區,錦安里,1112,389,1286,1067,-174,-678,-13.53,-63.543
63000030017,臺北市,大安區,福住里,1065,366,1221,1160,-156,-794,-12.776,-68.448
63000030018,臺北市,大安區,永康里,711,233,761,670,-50,-437,-6.57,-65.224
63000030019,臺北市,大安區,光明里,698,191,782,684,-84,-493,-10.742,-72.076
63000030020,臺北市,大安區,錦泰里,696,194,861,635,-165,-441,-19.164,-69.449
63000030021,臺北市,大安區,錦華里,1167,323,1312,1050,-145,-727,-11.052,-69.238
63000030022,臺北市,大安區,龍圖里,1348,334,1559,1140,-211,-806,-13.534,-70.702
63000030023,臺北市,大安區,新龍里,1674,287,1897,985,-223,-698,-11.755,-70.863
63000030026,臺北市,大安區,龍陣里,701,239,820,648,-119,-409,-14.512,-63.117
63000030027,臺北市,大安區,龍雲里,933,261,1061,933,-128,-672,-12.064,-72.026
63000030028,臺北市,大安區,龍生里,1369,348,1553,1194,-184,-846,-11.848,-70.854
63000030029,臺北市,大安區,住安里,932,279,1072,805,-140,-526,-13.06,-65.342
63000030030,臺北市,大安區,義安里,987,242,1186,887,-199,-645,-16.779,-72.717
63000030031,臺北市,大安區,通化里,1137,388,1219,1256,-82,-868,-6.727,-69.108
63000030032,臺北市,大安區,通安里,1068,347,1150,1033,-82,-686,-7.13,-66.409
63000030033,臺北市,大安區,臨江里,830,246,870,758,-40,-512,-4.598,-67.546
63000030034,臺北市,大安區,法治里,1093,245,1132,735,-39,-490,-3.445,-66.667
63000030035,臺北市,大安區,全安里,944,226,1026,762,-82,-536,-7.992,-70.341
63000030036,臺北市,大安區,群賢里,1148,247,1449,948,-301,-701,-20.773,-73.945
63000030037,臺北市,大安區,群英里,2083,318,2209,920,-126,-602,-5.704,-65.435
63000030038,臺北市,大安區,虎嘯里,778,213,853,700,-75,-487,-8.792,-69.571
63000030039,臺北市,大安區,臥龍里,440,112,508,362,-68,-250,-13.386,-69.061
63000030040,臺北市,大安區,龍淵里,1672,516,1955,1725,-283,-1209,-14.476,-70.087
63000030041,臺北市,大安區,龍門里,815,244,960,880,-145,-636,-15.104,-72.273
63000030043,臺北市,大安區,大學里,1784,583,1963,1677,-179,-1094,-9.119,-65.236
63000030044,臺北市,大安區,芳和里,1178,315,1337,1001,-159,-686,-11.892,-68.531
63000030046,臺北市,大安區,黎元里,1092,278,1130,958,-38,-680,-3.363,-70.981
63000030047,臺北市,大安區,黎孝里,1707,493,1742,1453,-35,-960,-2.009,-66.07
63000030048,臺北市,大安區,黎和里,1130,288,1097,779,33,-491,3.008,-63.03
63000030049,臺北市,大安區,建安里,917,262,1009,812,-92,-550,-9.118,-67.734
63000030050,臺北市,大安區,建倫里,1034,309,1231,1036,-197,-727,-16.003,-70.174
63000030051,臺北市,大安區,敦安里,1033,304,1222,1123,-189,-819,-15.466,-72.93
63000030052,臺北市,大安區,正聲里,844,225,995,766,-151,-541,-15.176,-70.627
63000030053,臺北市,大安區,敦煌里,1058,321,1229,1107,-171,-786,-13.914,-71.003
63000030054,臺北市,大安區,華聲里,712,181,860,717,-148,-536,-17.209,-74.756
63000030055,臺北市,大安區,車層里,1016,310,1273,1162,-257,-852,-20.189,-73.322
63000030056,臺北市,大安區,光信里,1447,448,1675,1379,-228,-931,-13.612,-67.513
63000030057,臺北市,大安區,學府里,437,124,579,391,-142,-267,-24.525,-68.286
63000040001,臺北市,中山區,正守里,596,212,603,668,-7,-456,-1.161,-68.263
63000040002,臺北市,中山區,正義里,940,298,920,928,20,-630,2.174,-67.888
63000040003,臺北市,中山區,正得里,704,265,669,701,35,-436,5.232,-62.197
63000040004,臺北市,中山區,民安里,704,404,809,1011,-105,-607,-12.979,-60.04
63000040005,臺北市,中山區,康樂里,519,177,518,487,1,-310,0.193,-63.655
63000040006,臺北市,中山區,中山里,1171,442,1161,1332,10,-890,0.861,-66.817
63000040007,臺北市,中山區,聚盛里,641,179,761,702,-120,-523,-15.769,-74.501
63000040008,臺北市,中山區,集英里,1194,504,1166,1553,28,-1049,2.401,-67.547
63000040009,臺北市,中山區,聚葉里,680,270,667,821,13,-551,1.949,-67.113
63000040010,臺北市,中山區,恆安里,908,283,823,953,85,-670,10.328,-70.304
63000040011,臺北市,中山區,晴光里,1028,328,977,962,51,-634,5.22,-65.904
63000040012,臺北市,中山區,圓山里,651,287,700,842,-49,-555,-7.0,-65.914
63000040019,臺北市,中山區,新庄里,835,365,883,1113,-48,-748,-5.436,-67.206
63000040013,臺北市,中山區,劍潭里,1107,130,1169,384,-62,-254,-5.304,-66.146
63000040014,臺北市,中山區,大直里,1793,501,2037,1655,-244,-1154,-11.978,-69.728
63000040015,臺北市,中山區,成功里,1097,311,1201,1272,-104,-961,-8.659,-75.55
63000040016,臺北市,中山區,永安里,1794,521,1979,1832,-185,-1311,-9.348,-71.561
63000040041,臺北市,中山區,金泰里,1590,424,1520,1376,70,-952,4.605,-69.186
63000040042,臺北市,中山區,北安里,507,116,620,459,-113,-343,-18.226,-74.728
63000040018,臺北市,中山區,新喜里,795,303,823,1125,-28,-822,-3.402,-73.067
63000040020,臺北市,中山區,新福里,858,465,822,1286,36,-821,4.38,-63.841
63000040021,臺北市,中山區,松江里,1064,450,1132,1432,-68,-982,-6.007,-68.575
63000040022,臺北市,中山區,新生里,824,331,788,1066,36,-735,4.569,-68.949
63000040023,臺北市,中山區,中庄里,870,416,817,1136,53,-720,6.487,-63.38
63000040017,臺北市,中山區,大佳里,95,70,134,278,-39,-208,-29.104,-74.82
63000040024,臺北市,中山區,行政里,1091,390,1112,1221,-21,-831,-1.888,-68.059
63000040025,臺北市,中山區,行仁里,1276,520,1303,1770,-27,-1250,-2.072,-70.621
63000040026,臺北市,中山區,行孝里,725,278,632,955,93,-677,14.715,-70.89
63000040027,臺北市,中山區,下埤里,1335,533,1353,1721,-18,-1188,-1.33,-69.03
63000040028,臺北市,中山區,江寧里,1291,470,1382,1462,-91,-992,-6.585,-67.852
63000040029,臺北市,中山區,江山里,1258,534,1377,1727,-119,-1193,-8.642,-69.079
63000040030,臺北市,中山區,中吉里,862,447,970,1297,-108,-850,-11.134,-65.536
63000040031,臺北市,中山區,中原里,883,396,933,1258,-50,-862,-5.359,-68.521
63000040032,臺北市,中山區,興亞里,937,384,978,1173,-41,-789,-4.192,-67.263
63000040033,臺北市,中山區,中央里,704,254,669,799,35,-545,5.232,-68.21
63000040034,臺北市,中山區,朱馥里,946,269,1021,1052,-75,-783,-7.346,-74.43
63000040035,臺北市,中山區,龍洲里,1424,225,1496,737,-72,-512,-4.813,-69.471
63000040036,臺北市,中山區,朱園里,819,321,820,1041,-1,-720,-0.122,-69.164
63000040037,臺北市,中山區,埤頭里,640,209,638,670,2,-461,0.313,-68.806
63000040038,臺北市,中山區,朱崙里,588,207,549,659,39,-452,7.104,-68.589
63000040039,臺北市,中山區,力行里,1083,405,1102,1381,-19,-976,-1.724,-70.673
63000040040,臺北市,中山區,復華里,945,284,1048,884,-103,-600,-9.828,-67.873
63000050022,臺北市,中正區,建國里,265,67,319,243,-54,-176,-16.928,-72.428
63000050023,臺北市,中正區,光復里,614,176,719,681,-105,-505,-14.604,-74.156
63000050024,臺北市,中正區,黎明里,459,145,567,509,-108,-364,-19.048,-71.513
63000050025,臺北市,中正區,梅花里,603,245,611,677,-8,-432,-1.309,-63.811
63000050026,臺北市,中正區,幸福里,862,250,1030,877,-168,-627,-16.311,-71.494
63000050027,臺北市,中正區,幸市里,865,323,961,965,-96,-642,-9.99,-66.528
63000050028,臺北市,中正區,東門里,774,190,864,636,-90,-446,-10.417,-70.126
63000050029,臺北市,中正區,文北里,1022,378,1185,1111,-163,-733,-13.755,-65.977
63000050030,臺北市,中正區,文祥里,1322,460,1602,1465,-280,-1005,-17.478,-68.601
63000050031,臺北市,中正區,三愛里,1504,512,1737,1637,-233,-1125,-13.414,-68.723
63000050011,臺北市,中正區,永功里,1095,406,1246,1220,-151,-814,-12.119,-66.721
63000050012,臺北市,中正區,永昌里,983,286,1044,936,-61,-650,-5.843,-69.444
63000050015,臺北市,中正區,廈安里,614,200,750,836,-136,-636,-18.133,-76.077
63000050013,臺北市,中正區,龍興里,549,162,653,675,-104,-513,-15.926,-76.0
63000050014,臺北市,中正區,忠勤里,1205,287,1329,998,-124,-711,-9.33,-71.242
63000050017,臺北市,中正區,南門里,521,166,642,477,-121,-311,-18.847,-65.199
63000050016,臺北市,中正區,愛國里,517,199,607,622,-90,-423,-14.827,-68.006
63000050018,臺北市,中正區,龍光里,577,163,745,607,-168,-444,-22.55,-73.147
63000050019,臺北市,中正區,南福里,2025,587,2364,2044,-339,-1457,-14.34,-71.282
63000050020,臺北市,中正區,龍福里,931,323,1067,956,-136,-633,-12.746,-66.213
63000050021,臺北市,中正區,新營里,1438,373,1893,1381,-455,-1008,-24.036,-72.991
63000050001,臺北市,中正區,水源里,546,146,586,602,-40,-456,-6.826,-75.748
63000050002,臺北市,中正區,富水里,512,83,575,318,-63,-235,-10.957,-73.899
63000050003,臺北市,中正區,文盛里,537,157,573,540,-36,-383,-6.283,-70.926
63000050004,臺北市,中正區,林興里,961,255,1074,820,-113,-565,-10.521,-68.902
63000050005,臺北市,中正區,河堤里,960,278,1109,838,-149,-560,-13.436,-66.826
63000050007,臺北市,中正區,網溪里,1220,359,1320,1165,-100,-806,-7.576,-69.185
63000050006,臺北市,中正區,頂東里,1271,415,1398,1280,-127,-865,-9.084,-67.578
63000050008,臺北市,中正區,板溪里,768,207,712,587,56,-380,7.865,-64.736
63000050009,臺北市,中正區,螢圃里,1140,340,1319,1050,-179,-710,-13.571,-67.619
63000050010,臺北市,中正區,螢雪里,867,228,960,805,-93,-577,-9.688,-71.677
63000060001,臺北市,大同區,玉泉里,418,211,461,675,-43,-464,-9.328,-68.741
63000060002,臺北市,大同區,建明里,478,212,492,727,-14,-515,-2.846,-70.839
63000060003,臺北市,大同區,建功里,667,307,717,1015,-50,-708,-6.974,-69.754
63000060004,臺北市,大同區,建泰里,509,283,550,873,-41,-590,-7.455,-67.583
63000060005,臺北市,大同區,永樂里,738,408,766,1274,-28,-866,-3.655,-67.975
63000060006,臺北市,大同區,朝陽里,707,351,753,1044,-46,-693,-6.109,-66.379
63000060007,臺北市,大同區,星明里,865,404,927,1252,-62,-848,-6.688,-67.732
63000060008,臺北市,大同區,光能里,771,382,775,1177,-4,-795,-0.516,-67.545
63000060009,臺北市,大同區,大有里,569,339,650,1158,-81,-819,-12.462,-70.725
63000060010,臺北市,大同區,延平里,577,290,679,916,-102,-626,-15.022,-68.341
63000060011,臺北市,大同區,雙連里,1280,630,1392,2039,-112,-1409,-8.046,-69.103
63000060012,臺北市,大同區,南芳里,626,310,588,953,38,-643,6.463,-67.471
63000060013,臺北市,大同區,民權里,986,469,1044,1432,-58,-963,-5.556,-67.249
63000060014,臺北市,大同區,景星里,340,221,368,613,-28,-392,-7.609,-63.948
63000060015,臺北市,大同區,隆和里,536,258,517,895,19,-637,3.675,-71.173
63000060016,臺北市,大同區,蓬萊里,749,322,793,1158,-44,-836,-5.549,-72.193
63000060017,臺北市,大同區,國順里,423,256,361,640,62,-384,17.175,-60.0
63000060018,臺北市,大同區,國慶里,706,368,754,1149,-48,-781,-6.366,-67.972
63000060019,臺北市,大同區,揚雅里,509,296,531,893,-22,-597,-4.143,-66.853
63000060020,臺北市,大同區,斯文里,690,392,677,1134,13,-742,1.92,-65.432
63000060021,臺北市,大同區,鄰江里,892,450,979,1613,-87,-1163,-8.887,-72.102
63000060022,臺北市,大同區,至聖里,1161,590,1252,1926,-91,-1336,-7.268,-69.367
63000060024,臺北市,大同區,老師里,815,418,785,1370,30,-952,3.822,-69.489
63000060025,臺北市,大同區,重慶里,1150,458,1195,1493,-45,-1035,-3.766,-69.324
63000060026,臺北市,大同區,保安里,650,414,685,1170,-35,-756,-5.109,-64.615
63000070001,臺北市,萬華區,福星里,917,253,1028,924,-111,-671,-10.798,-72.619
63000070002,臺北市,萬華區,萬壽里,516,144,579,536,-63,-392,-10.881,-73.134
63000070003,臺北市,萬華區,西門里,641,178,698,640,-57,-462,-8.166,-72.188
63000070004,臺北市,萬華區,新起里,1295,480,1297,1400,-2,-920,-0.154,-65.714
63000070005,臺北市,萬華區,菜園里,976,483,1105,1400,-129,-917,-11.674,-65.5
63000070006,臺北市,萬華區,青山里,961,383,1006,1249,-45,-866,-4.473,-69.335
63000070007,臺北市,萬華區,富民里,812,362,778,1182,34,-820,4.37,-69.374
63000070008,臺北市,萬華區,福音里,636,267,661,908,-25,-641,-3.782,-70.595
63000070009,臺北市,萬華區,仁德里,913,392,929,1093,-16,-701,-1.722,-64.135
63000070010,臺北市,萬華區,富福里,692,346,775,1139,-83,-793,-10.71,-69.622
63000070019,臺北市,萬華區,柳鄉里,706,313,756,1143,-50,-830,-6.614,-72.616
63000070018,臺北市,萬華區,華江里,1433,545,1421,1774,12,-1229,0.844,-69.278
63000070015,臺北市,萬華區,糖廍里,861,413,937,1267,-76,-854,-8.111,-67.403
63000070017,臺北市,萬華區,綠堤里,672,219,736,777,-64,-558,-8.696,-71.815
63000070011,臺北市,萬華區,頂碩里,1087,524,1170,1640,-83,-1116,-7.094,-68.049
63000070012,臺北市,萬華區,雙園里,822,300,755,1014,67,-714,8.874,-70.414
63000070016,臺北市,萬華區,和平里,866,467,889,1588,-23,-1121,-2.587,-70.592
63000070024,臺北市,萬華區,和德里,888,426,958,1340,-70,-914,-7.307,-68.209
63000070026,臺北市,萬華區,全德里,671,270,776,905,-105,-635,-13.531,-70.166
63000070020,臺北市,萬華區,日善里,645,289,621,829,24,-540,3.865,-65.139
63000070022,臺北市,萬華區,忠德里,733,326,726,1023,7,-697,0.964,-68.133
63000070025,臺北市,萬華區,錦德里,839,386,925,1172,-86,-786,-9.297,-67.065
63000070023,臺北市,萬華區,孝德里,559,280,504,811,55,-531,10.913,-65.475
63000070030,臺北市,萬華區,壽德里,801,298,907,1039,-106,-741,-11.687,-71.319
63000070028,臺北市,萬華區,銘德里,725,320,752,1018,-27,-698,-3.59,-68.566
63000070027,臺北市,萬華區,保德里,534,232,597,738,-63,-506,-10.553,-68.564
63000070029,臺北市,萬華區,榮德里,642,318,635,851,7,-533,1.102,-62.632
63000070032,臺北市,萬華區,華中里,1056,408,1032,1415,24,-1007,2.326,-71.166
63000070031,臺北市,萬華區,興德里,626,265,764,975,-138,-710,-18.063,-72.821
63000070033,臺北市,萬華區,日祥里,1573,385,1580,980,-7,-595,-0.443,-60.714
63000070034,臺北市,萬華區,忠貞里,1098,224,1279,668,-181,-444,-14.152,-66.467
63000070013,臺北市,萬華區,新忠里,1003,139,1160,365,-157,-226,-13.534,-61.918
63000070014,臺北市,萬華區,新和里,2403,361,2663,1097,-260,-736,-9.763,-67.092
63000070021,臺北市,萬華區,新安里,1122,249,1291,922,-169,-673,-13.091,-72.993
63000070035,臺北市,萬華區,凌霄里,866,193,919,539,-53,-346,-5.767,-64.193
63000070036,臺北市,萬華區,騰雲里,658,158,821,513,-163,-355,-19.854,-69.201
63000080001,臺北市,文山區,景行里,1405,474,1515,1375,-110,-901,-7.261,-65.527
63000080002,臺北市,文山區,景東里,1482,348,1778,1043,-296,-695,-16.648,-66.635
63000080003,臺北市,文山區,景美里,1034,299,1091,967,-57,-668,-5.225,-69.08
63000080004,臺北市,文山區,景慶里,1330,344,1480,1150,-150,-806,-10.135,-70.087
63000080005,臺北市,文山區,景仁里,1375,299,1375,962,0,-663,0.0,-68.919
63000080006,臺北市,文山區,景華里,1215,308,1403,962,-188,-654,-13.4,-67.983
63000080007,臺北市,文山區,萬有里,1216,303,1385,945,-169,-642,-12.202,-67.937
63000080008,臺北市,文山區,萬祥里,950,242,1039,825,-89,-583,-8.566,-70.667
63000080009,臺北市,文山區,萬隆里,1606,393,1804,1208,-198,-815,-10.976,-67.467
63000080010,臺北市,文山區,萬年里,1133,322,1264,988,-131,-666,-10.364,-67.409
63000080011,臺北市,文山區,萬和里,960,162,972,462,-12,-300,-1.235,-64.935
63000080012,臺北市,文山區,萬盛里,1052,283,1138,807,-86,-524,-7.557,-64.932
63000080013,臺北市,文山區,興豐里,1111,281,1247,873,-136,-592,-10.906,-67.812
63000080042,臺北市,文山區,興邦里,1268,213,1449,696,-181,-483,-12.491,-69.397
63000080014,臺北市,文山區,興光里,777,172,873,579,-96,-407,-10.997,-70.294
63000080015,臺北市,文山區,興家里,1818,380,1937,1164,-119,-784,-6.144,-67.354
63000080016,臺北市,文山區,興得里,1381,263,1460,938,-79,-675,-5.411,-71.962
63000080017,臺北市,文山區,興業里,1259,236,1467,799,-208,-563,-14.179,-70.463
63000080018,臺北市,文山區,興安里,1698,347,1791,1100,-93,-753,-5.193,-68.455
63000080019,臺北市,文山區,興福里,1129,337,1275,1016,-146,-679,-11.451,-66.831
63000080020,臺北市,文山區,興旺里,1924,388,2059,1186,-135,-798,-6.557,-67.285
63000080021,臺北市,文山區,興泰里,879,217,1009,726,-130,-509,-12.884,-70.11
63000080022,臺北市,文山區,興昌里,1436,321,1687,1025,-251,-704,-14.878,-68.683
63000080023,臺北市,文山區,試院里,1643,331,1860,1045,-217,-714,-11.667,-68.325
63000080024,臺北市,文山區,華興里,2043,448,2326,1459,-283,-1011,-12.167,-69.294
63000080025,臺北市,文山區,明義里,761,193,900,637,-139,-444,-15.444,-69.702
63000080026,臺北市,文山區,明興里,1537,334,1701,1093,-164,-759,-9.641,-69.442
63000080027,臺北市,文山區,木柵里,2458,456,2537,1304,-79,-848,-3.114,-65.031
63000080028,臺北市,文山區,木新里,1795,460,1918,1543,-123,-1083,-6.413,-70.188
63000080029,臺北市,文山區,順興里,1536,376,1702,1279,-166,-903,-9.753,-70.602
63000080038,臺北市,文山區,忠順里,1011,159,1257,638,-246,-479,-19.57,-75.078
63000080030,臺北市,文山區,樟林里,1790,365,2056,1228,-266,-863,-12.938,-70.277
63000080031,臺北市,文山區,樟新里,1185,239,1412,878,-227,-639,-16.076,-72.779
63000080041,臺北市,文山區,樟文里,1127,286,1384,1066,-257,-780,-18.569,-73.171
63000080032,臺北市,文山區,樟腳里,1170,273,1285,956,-115,-683,-8.949,-71.444
63000080043,臺北市,文山區,樟樹里,970,239,1058,849,-88,-610,-8.318,-71.849
63000080033,臺北市,文山區,萬芳里,1801,379,1984,1219,-183,-840,-9.224,-68.909
63000080039,臺北市,文山區,萬美里,1508,333,1728,1093,-220,-760,-12.731,-69.533
63000080034,臺北市,文山區,博嘉里,1240,264,1337,1022,-97,-758,-7.255,-74.168
63000080035,臺北市,文山區,萬興里,1752,403,1962,1537,-210,-1134,-10.703,-73.78
63000080040,臺北市,文山區,政大里,1484,322,1738,1265,-254,-943,-14.614,-74.545
63000080036,臺北市,文山區,指南里,779,231,777,756,2,-525,0.257,-69.444
63000080037,臺北市,文山區,老泉里,116,45,125,219,-9,-174,-7.2,-79.452
63000090001,臺北市,南港區,南港里,971,258,1093,1074,-122,-816,-11.162,-75.978
63000090002,臺北市,南港區,中南里,560,181,568,667,-8,-486,-1.408,-72.864
63000090004,臺北市,南港區,三重里,1295,303,1397,1308,-102,-1005,-7.301,-76.835
63000090003,臺北市,南港區,新富里,566,201,667,804,-101,-603,-15.142,-75.0
63000090017,臺北市,南港區,中研里,1604,510,1751,1822,-147,-1312,-8.395,-72.009
63000090018,臺北市,南港區,九如里,1268,304,1375,1011,-107,-707,-7.782,-69.931
63000090016,臺北市,南港區,舊莊里,1454,433,1465,1543,-11,-1110,-0.751,-71.938
63000090005,臺北市,南港區,東新里,1185,352,1273,1313,-88,-961,-6.913,-73.191
63000090020,臺北市,南港區,重陽里,1322,351,1158,944,164,-593,14.162,-62.818
63000090007,臺北市,南港區,東明里,1215,278,1281,1028,-66,-750,-5.152,-72.957
63000090008,臺北市,南港區,西新里,694,272,731,1054,-37,-782,-5.062,-74.194
63000090009,臺北市,南港區,玉成里,768,310,862,995,-94,-685,-10.905,-68.844
63000090010,臺北市,南港區,合成里,1275,437,1352,1363,-77,-926,-5.695,-67.938
63000090006,臺北市,南港區,新光里,678,175,782,675,-104,-500,-13.299,-74.074
63000090015,臺北市,南港區,聯成里,926,284,1070,928,-144,-644,-13.458,-69.397
63000090012,臺北市,南港區,萬福里,1028,282,1028,858,0,-576,0.0,-67.133
63000090013,臺北市,南港區,鴻福里,876,261,950,899,-74,-638,-7.789,-70.968
63000090014,臺北市,南港區,百福里,904,269,979,1015,-75,-746,-7.661,-73.498
63000090011,臺北市,南港區,成福里,1550,361,1735,1302,-185,-941,-10.663,-72.273
63000090019,臺北市,南港區,仁福里,1375,307,1459,901,-84,-594,-5.757,-65.927
63000100001,臺北市,內湖區,西湖里,1358,491,1407,1485,-49,-994,-3.483,-66.936
63000100002,臺北市,內湖區,西康里,2018,523,2182,1782,-164,-1259,-7.516,-70.651
63000100003,臺北市,內湖區,西安里,1381,386,1454,1287,-73,-901,-5.021,-70.008
63000100005,臺北市,內湖區,港墘里,1147,349,1243,1219,-96,-870,-7.723,-71.37
63000100006,臺北市,內湖區,港都里,883,298,1058,1065,-175,-767,-16.541,-72.019
63000100007,臺北市,內湖區,港富里,1789,537,1974,1784,-185,-1247,-9.372,-69.899
63000100008,臺北市,內湖區,港華里,1712,491,1812,1735,-100,-1244,-5.519,-71.7
63000100009,臺北市,內湖區,內湖里,1397,385,1439,1166,-42,-781,-2.919,-66.981
63000100010,臺北市,內湖區,湖濱里,1950,491,2115,1545,-165,-1054,-7.801,-68.22
63000100011,臺北市,內湖區,紫星里,1521,496,1639,1694,-118,-1198,-7.2,-70.72
63000100012,臺北市,內湖區,大湖里,1104,284,1179,1040,-75,-756,-6.361,-72.692
63000100013,臺北市,內湖區,金龍里,1080,317,1164,968,-84,-651,-7.216,-67.252
63000100014,臺北市,內湖區,金瑞里,1288,484,1419,1427,-131,-943,-9.232,-66.083
63000100015,臺北市,內湖區,碧山里,1561,407,1559,1338,2,-931,0.128,-69.581
63000100016,臺北市,內湖區,紫雲里,1349,323,1423,941,-74,-618,-5.2,-65.675
63000100017,臺北市,內湖區,清白里,1811,478,1920,1610,-109,-1132,-5.677,-70.311
63000100018,臺北市,內湖區,葫洲里,1372,271,1528,1156,-156,-885,-10.209,-76.557
63000100019,臺北市,內湖區,紫陽里,1666,454,1776,1601,-110,-1147,-6.194,-71.643
63000100020,臺北市,內湖區,瑞陽里,2012,429,2120,1302,-108,-873,-5.094,-67.051
63000100021,臺北市,內湖區,瑞光里,1086,226,1204,742,-118,-516,-9.801,-69.542
63000100022,臺北市,內湖區,五分里,1570,412,1722,1704,-152,-1292,-8.827,-75.822
63000100023,臺北市,內湖區,東湖里,1482,439,1503,1449,-21,-1010,-1.397,-69.703
63000100024,臺北市,內湖區,樂康里,1380,374,1472,1430,-92,-1056,-6.25,-73.846
63000100025,臺北市,內湖區,內溝里,940,247,949,843,-9,-596,-0.948,-70.7
63000100026,臺北市,內湖區,週美里,1594,519,1581,1731,13,-1212,0.822,-70.017
63000100027,臺北市,內湖區,行善里,1501,533,1417,1520,84,-987,5.928,-64.934
63000100028,臺北市,內湖區,石潭里,763,186,770,674,-7,-488,-0.909,-72.404
63000100029,臺北市,內湖區,湖興里,1333,352,1424,1307,-91,-955,-6.39,-73.068
63000100030,臺北市,內湖區,湖元里,1159,402,1061,1041,98,-639,9.237,-61.383
63000100031,臺北市,內湖區,安湖里,1271,387,1451,1414,-180,-1027,-12.405,-72.631
63000100032,臺北市,內湖區,秀湖里,1281,273,1487,1093,-206,-820,-13.853,-75.023
63000100033,臺北市,內湖區,安泰里,1065,255,1044,912,21,-657,2.011,-72.039
63000100034,臺北市,內湖區,金湖里,1831,408,2092,1690,-261,-1282,-12.476,-75.858
63000100035,臺北市,內湖區,康寧里,1729,415,1845,1494,-116,-1079,-6.287,-72.222
63000100036,臺北市,內湖區,明湖里,951,248,952,1040,-1,-792,-0.105,-76.154
63000100037,臺北市,內湖區,蘆洲里,156,51,163,227,-7,-176,-4.294,-77.533
63000100038,臺北市,內湖區,麗山里,1023,352,1067,1219,-44,-867,-4.124,-71.124
63000100039,臺北市,內湖區,寶湖里,1991,461,2065,1629,-74,-1168,-3.584,-71.7
63000100040,臺北市,內湖區,南湖里,1085,251,1201,932,-116,-681,-9.659,-73.069
63000110001,臺北市,士林區,仁勇里,605,332,629,921,-24,-589,-3.816,-63.952
63000110002,臺北市,士林區,義信里,584,159,592,647,-8,-488,-1.351,-75.425
63000110003,臺北市,士林區,福林里,506,222,521,610,-15,-388,-2.879,-63.607
63000110004,臺北市,士林區,福德里,827,292,928,905,-101,-613,-10.884,-67.735
63000110005,臺北市,士林區,福志里,1581,536,1699,1679,-118,-1143,-6.945,-68.076
63000110006,臺北市,士林區,舊佳里,1149,464,1200,1397,-51,-933,-4.25,-66.786
63000110007,臺北市,士林區,福佳里,1427,552,1479,1700,-52,-1148,-3.516,-67.529
63000110008,臺北市,士林區,後港里,1099,542,1184,1766,-85,-1224,-7.179,-69.309
63000110009,臺北市,士林區,福中里,1094,469,1078,1563,16,-1094,1.484,-69.994
63000110010,臺北市,士林區,前港里,681,291,666,1065,15,-774,2.252,-72.676
63000110011,臺北市,士林區,百齡里,1138,504,1126,1652,12,-1148,1.066,-69.492
63000110012,臺北市,士林區,承德里,966,309,1048,1134,-82,-825,-7.824,-72.751
63000110013,臺北市,士林區,福華里,951,461,959,1290,-8,-829,-0.834,-64.264
63000110014,臺北市,士林區,明勝里,845,396,888,1105,-43,-709,-4.842,-64.163
63000110015,臺北市,士林區,福順里,840,478,830,1338,10,-860,1.205,-64.275
63000110016,臺北市,士林區,富光里,900,431,851,1383,49,-952,5.758,-68.836
63000110017,臺北市,士林區,葫蘆里,1206,469,1251,1649,-45,-1180,-3.597,-71.559
63000110018,臺北市,士林區,葫東里,650,253,642,966,8,-713,1.246,-73.81
63000110019,臺北市,士林區,社子里,863,446,907,1516,-44,-1070,-4.851,-70.58
63000110020,臺北市,士林區,社新里,1222,610,1172,2088,50,-1478,4.266,-70.785
63000110021,臺北市,士林區,社園里,1026,565,945,1811,81,-1246,8.571,-68.802
63000110022,臺北市,士林區,永倫里,904,538,960,1726,-56,-1188,-5.833,-68.83
63000110023,臺北市,士林區,福安里,418,401,450,1446,-32,-1045,-7.111,-72.268
63000110024,臺北市,士林區,富洲里,653,470,602,1661,51,-1191,8.472,-71.704
63000110025,臺北市,士林區,岩山里,583,204,693,642,-110,-438,-15.873,-68.224
63000110026,臺北市,士林區,名山里,1424,523,1539,1561,-115,-1038,-7.472,-66.496
63000110029,臺北市,士林區,聖山里,1081,333,1164,975,-83,-642,-7.131,-65.846
63000110031,臺北市,士林區,芝山里,1420,473,1478,1671,-58,-1198,-3.924,-71.694
63000110032,臺北市,士林區,東山里,1014,294,1167,928,-153,-634,-13.111,-68.319
63000110030,臺北市,士林區,忠誠里,1183,291,1361,893,-178,-602,-13.079,-67.413
63000110027,臺北市,士林區,德行里,806,359,857,1008,-51,-649,-5.951,-64.385
63000110028,臺北市,士林區,德華里,851,392,1028,1259,-177,-867,-17.218,-68.864
63000110034,臺北市,士林區,蘭雅里,1541,581,1642,1783,-101,-1202,-6.151,-67.414
63000110035,臺北市,士林區,蘭興里,1120,492,1223,1457,-103,-965,-8.422,-66.232
63000110033,臺北市,士林區,三玉里,1095,407,1148,1200,-53,-793,-4.617,-66.083
63000110036,臺北市,士林區,天福里,1071,372,1176,1256,-105,-884,-8.929,-70.382
63000110037,臺北市,士林區,天祿里,861,373,947,1164,-86,-791,-9.081,-67.955
63000110038,臺北市,士林區,天壽里,858,333,980,1088,-122,-755,-12.449,-69.393
63000110039,臺北市,士林區,天和里,1369,502,1446,1550,-77,-1048,-5.325,-67.613
63000110040,臺北市,士林區,天山里,1301,414,1429,1365,-128,-951,-8.957,-69.67
63000110041,臺北市,士林區,天玉里,1562,498,1726,1809,-164,-1311,-9.502,-72.471
63000110042,臺北市,士林區,天母里,1337,386,1326,1358,11,-972,0.83,-71.576
63000110043,臺北市,士林區,永福里,174,89,185,335,-11,-246,-5.946,-73.433
63000110044,臺北市,士林區,公館里,144,106,159,338,-15,-232,-9.434,-68.639
63000110045,臺北市,士林區,新安里,286,171,295,497,-9,-326,-3.051,-65.594
63000110046,臺北市,士林區,陽明里,465,190,505,606,-40,-416,-7.921,-68.647
63000110047,臺北市,士林區,菁山里,237,75,219,338,18,-263,8.219,-77.811
63000110048,臺北市,士林區,平等里,158,142,140,411,18,-269,12.857,-65.45
63000110049,臺北市,士林區,溪山里,252,128,223,342,29,-214,13.004,-62.573
63000110050,臺北市,士林區,翠山里,676,145,784,414,-108,-269,-13.776,-64.976
63000110051,臺北市,士林區,臨溪里,525,190,600,560,-75,-370,-12.5,-66.071
63000120001,臺北市,北投區,建民里,751,367,794,1053,-43,-686,-5.416,-65.147
63000120002,臺北市,北投區,文林里,699,338,721,982,-22,-644,-3.051,-65.58
63000120003,臺北市,北投區,石牌里,912,368,937,1193,-25,-825,-2.668,-69.153
63000120004,臺北市,北投區,福興里,1299,482,1356,1529,-57,-1047,-4.204,-68.476
63000120005,臺北市,北投區,榮光里,1208,374,1239,1357,-31,-983,-2.502,-72.439
63000120006,臺北市,北投區,榮華里,1480,548,1511,1614,-31,-1066,-2.052,-66.047
63000120007,臺北市,北投區,裕民里,1402,489,1469,1580,-67,-1091,-4.561,-69.051
63000120008,臺北市,北投區,振華里,1414,399,1497,1490,-83,-1091,-5.544,-73.221
63000120009,臺北市,北投區,永和里,1700,675,1744,1974,-44,-1299,-2.523,-65.805
63000120010,臺北市,北投區,永欣里,1473,504,1683,1571,-210,-1067,-12.478,-67.919
63000120011,臺北市,北投區,永明里,900,301,994,990,-94,-689,-9.457,-69.596
63000120012,臺北市,北投區,東華里,922,264,1006,887,-84,-623,-8.35,-70.237
63000120013,臺北市,北投區,吉利里,1304,396,1370,1220,-66,-824,-4.818,-67.541
63000120014,臺北市,北投區,吉慶里,834,375,831,1170,3,-795,0.361,-67.949
63000120015,臺北市,北投區,尊賢里,768,326,727,1112,41,-786,5.64,-70.683
63000120016,臺北市,北投區,立賢里,930,370,972,1122,-42,-752,-4.321,-67.023
63000120017,臺北市,北投區,立農里,1640,672,1663,1956,-23,-1284,-1.383,-65.644
63000120018,臺北市,北投區,八仙里,936,351,985,1163,-49,-812,-4.975,-69.819
63000120019,臺北市,北投區,洲美里,341,194,316,618,25,-424,7.911,-68.608
63000120020,臺北市,北投區,奇岩里,1975,791,2067,2375,-92,-1584,-4.451,-66.695
63000120021,臺北市,北投區,清江里,1517,583,1536,1837,-19,-1254,-1.237,-68.263
63000120022,臺北市,北投區,中央里,1209,505,1309,1764,-100,-1259,-7.639,-71.372
63000120023,臺北市,北投區,長安里,952,397,982,1227,-30,-830,-3.055,-67.645
63000120024,臺北市,北投區,大同里,1006,456,879,1285,127,-829,14.448,-64.514
63000120025,臺北市,北投區,溫泉里,1102,458,1193,1418,-91,-960,-7.628,-67.701
63000120026,臺北市,北投區,林泉里,522,157,534,489,-12,-332,-2.247,-67.894
63000120027,臺北市,北投區,中心里,1098,394,1159,1191,-61,-797,-5.263,-66.919
63000120028,臺北市,北投區,中庸里,627,214,671,861,-44,-647,-6.557,-75.145
63000120029,臺北市,北投區,開明里,1257,378,1347,1320,-90,-942,-6.682,-71.364
63000120030,臺北市,北投區,中和里,927,329,1024,1049,-97,-720,-9.473,-68.637
63000120031,臺北市,北投區,智仁里,1126,367,1120,1132,6,-765,0.536,-67.58
63000120032,臺北市,北投區,秀山里,658,191,625,605,33,-414,5.28,-68.43
63000120033,臺北市,北投區,文化里,1007,155,1109,591,-102,-436,-9.197,-73.773
63000120034,臺北市,北投區,豐年里,713,196,735,753,-22,-557,-2.993,-73.971
63000120035,臺北市,北投區,稻香里,1096,333,1144,919,-48,-586,-4.196,-63.765
63000120036,臺北市,北投區,桃源里,1004,380,1029,1362,-25,-982,-2.43,-72.1
63000120037,臺北市,北投區,一德里,1180,422,1178,1546,2,-1124,0.17,-72.704
63000120038,臺北市,北投區,關渡里,1941,658,1979,2214,-38,-1556,-1.92,-70.28
63000120039,臺北市,北投區,泉源里,330,127,333,488,-3,-361,-0.901,-73.975
63000120040,臺北市,北投區,湖山里,264,92,253,327,11,-235,4.348,-71.865
63000120041,臺北市,北投區,大屯里,128,72,139,276,-11,-204,-7.914,-73.913
63000120042,臺北市,北投區,湖田里,148,43,133,184,15,-141,11.278,-76.63
10004010002,新竹縣,竹北市,鹿場里,3987,1336,2667,2178,1320,-842,49.494,-38.659
10004010003,新竹縣,竹北市,東平里,4254,1749,2676,2755,1578,-1006,58.969,-36.515
10004010004,新竹縣,竹北市,中興里,3075,1223,2001,1798,1074,-575,53.673,-31.98
10004010005,新竹縣,竹北市,隘口里,1528,547,725,586,803,-39,110.759,-6.655
10004010006,新竹縣,竹北市,東海里,1259,287,735,365,524,-78,71.293,-21.37
10004010027,新竹縣,竹北市,東興里,2930,1122,1413,1432,1517,-310,107.36,-21.648
10004010028,新竹縣,竹北市,北興里,2322,782,1094,1090,1228,-308,112.249,-28.257
10004010021,新竹縣,竹北市,十興里,2307,939,1597,1449,710,-510,44.458,-35.197
10004010029,新竹縣,竹北市,興安里,1368,370,896,577,472,-207,52.679,-35.875
10004010030,新竹縣,竹北市,文化里,1242,395,775,723,467,-328,60.258,-45.367
10004010001,新竹縣,竹北市,斗崙里,2649,884,1658,1336,991,-452,59.771,-33.832
10004010031,新竹縣,竹北市,中崙里,2527,781,1638,1189,889,-408,54.274,-34.315
10004010024,新竹縣,竹北市,北崙里,1461,411,1017,633,444,-222,43.658,-35.071
10004010025,新竹縣,竹北市,新崙里,2354,744,1397,1122,957,-378,68.504,-33.69
10004010007,新竹縣,竹北市,竹北里,2846,844,1725,1174,1121,-330,64.986,-28.109
10004010008,新竹縣,竹北市,竹仁里,3156,872,2185,1337,971,-465,44.439,-34.779
10004010026,新竹縣,竹北市,福德里,1162,351,817,531,345,-180,42.228,-33.898
10004010009,新竹縣,竹北市,竹義里,1947,552,1226,852,721,-300,58.809,-35.211
10004010010,新竹縣,竹北市,泰和里,2178,586,1367,869,811,-283,59.327,-32.566
10004010011,新竹縣,竹北市,新社里,1998,436,1595,1094,403,-658,25.266,-60.146
10004010022,新竹縣,竹北市,新國里,1795,379,1257,1061,538,-682,42.8,-64.279
10004010012,新竹縣,竹北市,聯興里,1207,249,1034,732,173,-483,16.731,-65.984
10004010013,新竹縣,竹北市,麻園里,526,131,389,364,137,-233,35.219,-64.011
10004010014,新竹縣,竹北市,溪州里,688,144,519,512,169,-368,32.563,-71.875
10004010023,新竹縣,竹北市,新庄里,321,70,230,164,91,-94,39.565,-57.317
10004010015,新竹縣,竹北市,白地里,481,122,408,392,73,-270,17.892,-68.878
10004010016,新竹縣,竹北市,新港里,274,101,181,315,93,-214,51.381,-67.937
10004010019,新竹縣,竹北市,大眉里,472,119,375,317,97,-198,25.867,-62.461
10004010017,新竹縣,竹北市,大義里,331,122,245,393,86,-271,35.102,-68.957
10004010020,新竹縣,竹北市,尚義里,309,116,226,394,83,-278,36.726,-70.558
10004010018,新竹縣,竹北市,崇義里,407,145,280,471,127,-326,45.357,-69.214
10004020001,新竹縣,竹東鎮,上坪里,91,26,72,28,19,-2,26.389,-7.143
10004020002,新竹縣,竹東鎮,瑞峰里,127,51,84,52,43,-1,51.19,-1.923
10004020003,新竹縣,竹東鎮,軟橋里,125,43,87,44,38,-1,43.678,-2.273
10004020004,新竹縣,竹東鎮,員崠里,797,177,592,239,205,-62,34.628,-25.941
10004020006,新竹縣,竹東鎮,上舘里,3380,731,2338,933,1042,-202,44.568,-21.651
10004020005,新竹縣,竹東鎮,東寧里,1279,291,886,371,393,-80,44.357,-21.563
10004020021,新竹縣,竹東鎮,中正里,1036,244,548,285,488,-41,89.051,-14.386
10004020007,新竹縣,竹東鎮,大鄉里,1617,361,1120,476,497,-115,44.375,-24.16
10004020020,新竹縣,竹東鎮,中山里,619,115,460,178,159,-63,34.565,-35.393
10004020022,新竹縣,竹東鎮,南華里,389,96,294,141,95,-45,32.313,-31.915
10004020008,新竹縣,竹東鎮,東華里,254,47,206,103,48,-56,23.301,-54.369
10004020009,新竹縣,竹東鎮,商華里,880,215,716,268,164,-53,22.905,-19.776
10004020010,新竹縣,竹東鎮,竹東里,477,152,338,241,139,-89,41.124,-36.929
10004020024,新竹縣,竹東鎮,忠孝里,505,117,373,186,132,-69,35.389,-37.097
10004020012,新竹縣,竹東鎮,鷄林里,1380,289,925,437,455,-148,49.189,-33.867
10004020013,新竹縣,竹東鎮,仁愛里,1192,292,845,427,347,-135,41.065,-31.616
10004020011,新竹縣,竹東鎮,榮樂里,498,112,411,185,87,-73,21.168,-39.459
10004020023,新竹縣,竹東鎮,榮華里,2892,675,1918,799,974,-124,50.782,-15.519
10004020014,新竹縣,竹東鎮,五豐里,2557,608,1604,811,953,-203,59.414,-25.031
10004020025,新竹縣,竹東鎮,陸豐里,227,52,159,87,68,-35,42.767,-40.23
10004020015,新竹縣,竹東鎮,三重里,2362,609,1539,833,823,-224,53.476,-26.891
10004020019,新竹縣,竹東鎮,二重里,4595,1196,2736,1677,1859,-481,67.946,-28.682
10004020016,新竹縣,竹東鎮,頭重里,1746,465,1218,672,528,-207,43.35,-30.804
10004020017,新竹縣,竹東鎮,員山里,719,205,465,306,254,-101,54.624,-33.007
10004020018,新竹縣,竹東鎮,柯湖里,224,66,141,91,83,-25,58.865,-27.473
10004030008,新竹縣,新埔鎮,新埔里,253,40,256,144,-3,-104,-1.172,-72.222
10004030009,新竹縣,新埔鎮,新生里,135,32,134,117,1,-85,0.746,-72.65
10004030010,新竹縣,新埔鎮,新民里,282,54,313,141,-31,-87,-9.904,-61.702
10004030007,新竹縣,新埔鎮,田新里,1244,204,802,458,442,-254,55.112,-55.459
10004030006,新竹縣,新埔鎮,旱坑里,481,76,414,272,67,-196,16.184,-72.059
10004030004,新竹縣,新埔鎮,五埔里,499,80,462,264,37,-184,8.009,-69.697
10004030005,新竹縣,新埔鎮,四座里,806,193,765,615,41,-422,5.359,-68.618
10004030016,新竹縣,新埔鎮,照門里,293,44,282,198,11,-154,3.901,-77.778
10004030017,新竹縣,新埔鎮,清水里,97,16,96,93,1,-77,1.042,-82.796
10004030018,新竹縣,新埔鎮,鹿鳴里,143,39,129,149,14,-110,10.853,-73.826
10004030019,新竹縣,新埔鎮,新北里,159,24,139,102,20,-78,14.388,-76.471
10004030015,新竹縣,新埔鎮,巨埔里,250,85,240,251,10,-166,4.167,-66.135
10004030001,新竹縣,新埔鎮,內立里,244,51,224,184,20,-133,8.929,-72.283
10004030002,新竹縣,新埔鎮,寶石里,227,35,229,139,-2,-104,-0.873,-74.82
10004030003,新竹縣,新埔鎮,文山里,1378,250,1130,682,248,-432,21.947,-63.343
10004030011,新竹縣,新埔鎮,上寮里,473,95,420,283,53,-188,12.619,-66.431
10004030012,新竹縣,新埔鎮,下寮里,707,126,615,433,92,-307,14.959,-70.901
10004030013,新竹縣,新埔鎮,南平里,237,44,246,185,-9,-141,-3.659,-76.216
10004030014,新竹縣,新埔鎮,北平里,136,35,139,117,-3,-82,-2.158,-70.085
10004040001,新竹縣,關西鎮,東興里,166,14,162,58,4,-44,2.469,-75.862
10004040002,新竹縣,關西鎮,西安里,574,48,541,220,33,-172,6.1,-78.182
10004040003,新竹縣,關西鎮,南雄里,200,24,195,94,5,-70,2.564,-74.468
10004040004,新竹縣,關西鎮,北斗里,1031,171,922,518,109,-347,11.822,-66.988
10004040006,新竹縣,關西鎮,北山里,183,37,182,137,1,-100,0.549,-72.993
10004040005,新竹縣,關西鎮,仁安里,226,42,242,158,-16,-116,-6.612,-73.418
10004040007,新竹縣,關西鎮,南山里,260,46,203,147,57,-101,28.079,-68.707
10004040008,新竹縣,關西鎮,東安里,986,135,833,475,153,-340,18.367,-71.579
10004040019,新竹縣,關西鎮,東山里,206,27,183,143,23,-116,12.568,-81.119
10004040009,新竹縣,關西鎮,東光里,278,53,278,171,0,-118,0.0,-69.006
10004040020,新竹縣,關西鎮,南新里,223,40,202,109,21,-69,10.396,-63.303
10004040010,新竹縣,關西鎮,新富里,101,17,96,75,5,-58,5.208,-77.333
10004040013,新竹縣,關西鎮,玉山里,81,20,69,61,12,-41,17.391,-67.213
10004040011,新竹縣,關西鎮,金山里,137,23,135,73,2,-50,1.481,-68.493
10004040012,新竹縣,關西鎮,錦山里,163,24,202,82,-39,-58,-19.307,-70.732
10004040014,新竹縣,關西鎮,大同里,155,44,167,179,-12,-135,-7.186,-75.419
10004040015,新竹縣,關西鎮,石光里,457,61,394,261,63,-200,15.99,-76.628
10004040021,新竹縣,關西鎮,東平里,259,50,252,153,7,-103,2.778,-67.32
10004040016,新竹縣,關西鎮,上林里,213,35,205,121,8,-86,3.902,-71.074
10004040017,新竹縣,關西鎮,新力里,177,23,150,64,27,-41,18.0,-64.062
10004040018,新竹縣,關西鎮,南和里,206,23,179,131,27,-108,15.084,-82.443
10004050007,新竹縣,湖口鄉,和興村,759,104,584,437,175,-333,29.966,-76.201
10004050019,新竹縣,湖口鄉,東興村,1403,225,909,555,494,-330,54.345,-59.459
10004050006,新竹縣,湖口鄉,德盛村,1214,180,1055,619,159,-439,15.071,-70.921
10004050003,新竹縣,湖口鄉,愛勢村,1121,168,998,559,123,-391,12.325,-69.946
10004050002,新竹縣,湖口鄉,仁勢村,250,37,230,148,20,-111,8.696,-75.0
10004050001,新竹縣,湖口鄉,孝勢村,367,68,346,171,21,-103,6.069,-60.234
10004050005,新竹縣,湖口鄉,中勢村,1073,153,805,442,268,-289,33.292,-65.385
10004050018,新竹縣,湖口鄉,中正村,1233,195,843,505,390,-310,46.263,-61.386
10004050004,新竹縣,湖口鄉,信勢村,1472,213,1231,709,241,-496,19.578,-69.958
10004050017,新竹縣,湖口鄉,信義村,1229,200,880,536,349,-336,39.659,-62.687
10004050013,新竹縣,湖口鄉,波羅村,623,107,459,287,164,-180,35.73,-62.718
10004050008,新竹縣,湖口鄉,長嶺村,846,129,720,396,126,-267,17.5,-67.424
10004050009,新竹縣,湖口鄉,長安村,250,45,219,152,31,-107,14.155,-70.395
10004050010,新竹縣,湖口鄉,湖口村,733,125,658,405,75,-280,11.398,-69.136
10004050011,新竹縣,湖口鄉,湖鏡村,739,87,734,268,5,-181,0.681,-67.537
10004050012,新竹縣,湖口鄉,湖南村,442,62,418,188,24,-126,5.742,-67.021
10004050016,新竹縣,湖口鄉,中興村,1679,222,1339,547,340,-325,25.392,-59.415
10004050014,新竹縣,湖口鄉,鳳凰村,1328,185,1064,553,264,-368,24.812,-66.546
10004050020,新竹縣,湖口鄉,勝利村,1141,145,950,416,191,-271,20.105,-65.144
10004050015,新竹縣,湖口鄉,鳳山村,941,118,848,323,93,-205,10.967,-63.467
10004060001,新竹縣,新豐鄉,福興村,278,55,237,163,41,-108,17.3,-66.258
10004060003,新竹縣,新豐鄉,青埔村,502,74,387,259,115,-185,29.716,-71.429
10004060007,新竹縣,新豐鄉,中崙村,835,130,687,406,148,-276,21.543,-67.98
10004060005,新竹縣,新豐鄉,瑞興村,410,75,349,226,61,-151,17.479,-66.814
10004060002,新竹縣,新豐鄉,後湖村,426,82,351,275,75,-193,21.368,-70.182
10004060006,新竹縣,新豐鄉,坡頭村,146,32,123,187,23,-155,18.699,-82.888
10004060004,新竹縣,新豐鄉,埔和村,542,167,434,580,108,-413,24.885,-71.207
10004060009,新竹縣,新豐鄉,新豐村,405,107,340,388,65,-281,19.118,-72.423
10004060010,新竹縣,新豐鄉,員山村,843,110,651,332,192,-222,29.493,-66.867
10004060014,新竹縣,新豐鄉,忠孝村,971,134,866,479,105,-345,12.125,-72.025
10004060015,新竹縣,新豐鄉,山崎村,1190,195,1095,614,95,-419,8.676,-68.241
10004060012,新竹縣,新豐鄉,上坑村,446,64,364,207,82,-143,22.527,-69.082
10004060013,新竹縣,新豐鄉,鳳坑村,264,62,246,153,18,-91,7.317,-59.477
10004060008,新竹縣,新豐鄉,重興村,1287,163,1088,669,199,-506,18.29,-75.635
10004060017,新竹縣,新豐鄉,崎頂村,833,152,620,374,213,-222,34.355,-59.358
10004060011,新竹縣,新豐鄉,松林村,1233,187,1092,611,141,-424,12.912,-69.394
10004060016,新竹縣,新豐鄉,松柏村,1831,276,1275,752,556,-476,43.608,-63.298
10004070002,新竹縣,芎林鄉,華龍村,112,13,118,49,-6,-36,-5.085,-73.469
10004070001,新竹縣,芎林鄉,五龍村,151,17,139,61,12,-44,8.633,-72.131
10004070003,新竹縣,芎林鄉,秀湖村,289,25,267,95,22,-70,8.24,-73.684
10004070004,新竹縣,芎林鄉,永興村,133,19,118,38,15,-19,12.712,-50.0
10004070005,新竹縣,芎林鄉,石潭村,739,107,687,333,52,-226,7.569,-67.868
10004070006,新竹縣,芎林鄉,新鳳村,387,84,378,210,9,-126,2.381,-60.0
10004070007,新竹縣,芎林鄉,中坑村,154,13,176,63,-22,-50,-12.5,-79.365
10004070008,新竹縣,芎林鄉,水坑村,215,31,192,117,23,-86,11.979,-73.504
10004070009,新竹縣,芎林鄉,文林村,762,99,655,269,107,-170,16.336,-63.197
10004070010,新竹縣,芎林鄉,芎林村,465,100,406,252,59,-152,14.532,-60.317
10004070011,新竹縣,芎林鄉,上山村,1692,333,1213,777,479,-444,39.489,-57.143
10004070012,新竹縣,芎林鄉,下山村,423,75,300,183,123,-108,41.0,-59.016
10004080001,新竹縣,橫山鄉,橫山村,1212,264,833,383,379,-119,45.498,-31.07
10004080002,新竹縣,橫山鄉,田寮村,324,99,213,131,111,-32,52.113,-24.427
10004080003,新竹縣,橫山鄉,南昌村,63,15,57,23,6,-8,10.526,-34.783
10004080004,新竹縣,橫山鄉,豐鄉村,59,25,41,34,18,-9,43.902,-26.471
10004080005,新竹縣,橫山鄉,豐田村,106,35,79,42,27,-7,34.177,-16.667
10004080006,新竹縣,橫山鄉,內灣村,283,91,229,109,54,-18,23.581,-16.514
10004080011,新竹縣,橫山鄉,力行村,313,73,248,91,65,-18,26.21,-19.78
10004080007,新竹縣,橫山鄉,福興村,133,33,103,58,30,-25,29.126,-43.103
10004080008,新竹縣,橫山鄉,沙坑村,312,98,266,141,46,-43,17.293,-30.496
10004080009,新竹縣,橫山鄉,新興村,585,125,466,160,119,-35,25.536,-21.875
10004080010,新竹縣,橫山鄉,大肚村,653,119,452,153,201,-34,44.469,-22.222
10004090001,新竹縣,北埔鄉,北埔村,381,89,274,139,107,-50,39.051,-35.971
10004090002,新竹縣,北埔鄉,南興村,412,94,291,124,121,-30,41.581,-24.194
10004090007,新竹縣,北埔鄉,大湖村,194,39,128,57,66,-18,51.562,-31.579
10004090003,新竹縣,北埔鄉,埔尾村,893,214,624,309,269,-95,43.109,-30.744
10004090004,新竹縣,北埔鄉,水磜村,278,72,167,114,111,-42,66.467,-36.842
10004090005,新竹縣,北埔鄉,南埔村,150,38,129,49,21,-11,16.279,-22.449
10004090006,新竹縣,北埔鄉,大林村,307,66,196,75,111,-9,56.633,-12.0
10004090008,新竹縣,北埔鄉,南坑村,118,30,97,45,21,-15,21.649,-33.333
10004090009,新竹縣,北埔鄉,外坪村,87,33,73,48,14,-15,19.178,-31.25
10004100010,新竹縣,寶山鄉,雙新村,852,267,661,369,191,-102,28.896,-27.642
10004100001,新竹縣,寶山鄉,雙溪村,886,263,605,411,281,-148,46.446,-36.01
10004100002,新竹縣,寶山鄉,大崎村,726,196,559,318,167,-122,29.875,-38.365
10004100003,新竹縣,寶山鄉,三峰村,356,100,240,154,116,-54,48.333,-35.065
10004100004,新竹縣,寶山鄉,新城村,382,119,255,170,127,-51,49.804,-30.0
10004100006,新竹縣,寶山鄉,寶斗村,223,43,155,74,68,-31,43.871,-41.892
10004100005,新竹縣,寶山鄉,深井村,277,57,210,117,67,-60,31.905,-51.282
10004100008,新竹縣,寶山鄉,寶山村,405,116,229,113,176,3,76.856,2.655
10004100009,新竹縣,寶山鄉,油田村,242,58,164,86,78,-28,47.561,-32.558
10004100007,新竹縣,寶山鄉,山湖村,202,64,159,90,43,-26,27.044,-28.889
10004110001,新竹縣,峨眉鄉,峨眉村,310,62,265,101,45,-39,16.981,-38.614
10004110002,新竹縣,峨眉鄉,中盛村,223,77,154,115,69,-38,44.805,-33.043
10004110003,新竹縣,峨眉鄉,石井村,198,58,160,82,38,-24,23.75,-29.268
10004110005,新竹縣,峨眉鄉,七星村,195,45,154,94,41,-49,26.623,-52.128
10004110004,新竹縣,峨眉鄉,富興村,444,125,323,171,121,-46,37.461,-26.901
10004110006,新竹縣,峨眉鄉,湖光村,262,105,185,142,77,-37,41.622,-26.056
10004120002,新竹縣,尖石鄉,嘉樂村,193,31,205,62,-12,-31,-5.854,-50.0
10004120001,新竹縣,尖石鄉,義興村,138,20,123,45,15,-25,12.195,-55.556
10004120003,新竹縣,尖石鄉,新樂村,275,27,262,48,13,-21,4.962,-43.75
10004120005,新竹縣,尖石鄉,錦屏村,249,19,204,53,45,-34,22.059,-64.151
10004120004,新竹縣,尖石鄉,梅花村,147,36,165,36,-18,0,-10.909,0.0
10004120006,新竹縣,尖石鄉,玉峰村,154,60,159,83,-5,-23,-3.145,-27.711
10004120007,新竹縣,尖石鄉,秀巒村,135,27,193,67,-58,-40,-30.052,-59.701
10004130001,新竹縣,五峰鄉,大隘村,288,39,302,42,-14,-3,-4.636,-7.143
10004130004,新竹縣,五峰鄉,桃山村,233,60,249,108,-16,-48,-6.426,-44.444
10004130002,新竹縣,五峰鄉,花園村,126,25,148,56,-22,-31,-14.865,-55.357
10004130003,新竹縣,五峰鄉,竹林村,70,11,77,23,-7,-12,-9.091,-52.174
10010080001,嘉義縣,六腳鄉,蒜頭村,205,82,176,263,29,-181,16.477,-68.821
10010080002,嘉義縣,六腳鄉,蒜東村,126,42,99,174,27,-132,27.273,-75.862
10010080003,嘉義縣,六腳鄉,蒜南村,125,71,97,224,28,-153,28.866,-68.304
10010080004,嘉義縣,六腳鄉,工廠村,67,5,59,40,8,-35,13.559,-87.5
10010080005,嘉義縣,六腳鄉,灣南村,196,71,142,284,54,-213,38.028,-75.0
10010080006,嘉義縣,六腳鄉,灣北村,175,57,159,207,16,-150,10.063,-72.464
10010080007,嘉義縣,六腳鄉,雙涵村,82,28,86,241,-4,-213,-4.651,-88.382
10010080008,嘉義縣,六腳鄉,塗師村,49,40,64,177,-15,-137,-23.438,-77.401
10010080009,嘉義縣,六腳鄉,三義村,63,58,63,199,0,-141,0.0,-70.854
10010080019,嘉義縣,六腳鄉,正義村,159,145,146,449,13,-304,8.904,-67.706
10010080020,嘉義縣,六腳鄉,溪厝村,81,45,63,156,18,-111,28.571,-71.154
10010080010,嘉義縣,六腳鄉,港美村,65,55,39,224,26,-169,66.667,-75.446
10010080011,嘉義縣,六腳鄉,豐美村,104,52,101,295,3,-243,2.97,-82.373
10010080012,嘉義縣,六腳鄉,六斗村,147,45,99,209,48,-164,48.485,-78.469
10010080013,嘉義縣,六腳鄉,崙陽村,159,60,103,251,56,-191,54.369,-76.096
10010080014,嘉義縣,六腳鄉,蘇厝村,227,75,138,346,89,-271,64.493,-78.324
10010080015,嘉義縣,六腳鄉,竹本村,66,28,53,150,13,-122,24.528,-81.333
10010080016,嘉義縣,六腳鄉,永賢村,40,25,30,116,10,-91,33.333,-78.448
10010080017,嘉義縣,六腳鄉,魚寮村,62,42,61,151,1,-109,1.639,-72.185
10010080018,嘉義縣,六腳鄉,潭墘村,125,50,98,194,27,-144,27.551,-74.227
10010080021,嘉義縣,六腳鄉,六腳村,111,33,107,162,4,-129,3.738,-79.63
10010080022,嘉義縣,六腳鄉,六南村,63,29,59,112,4,-83,6.78,-74.107
10010080023,嘉義縣,六腳鄉,崩山村,82,33,78,160,4,-127,5.128,-79.375
10010080024,嘉義縣,六腳鄉,古林村,66,41,52,212,14,-171,26.923,-80.66
10010080025,嘉義縣,六腳鄉,更寮村,73,41,55,139,18,-98,32.727,-70.504
10010090001,嘉義縣,東石鄉,東石村,272,107,226,443,46,-336,20.354,-75.847
10010090002,嘉義縣,東石鄉,猿樹村,107,38,105,195,2,-157,1.905,-80.513
10010090003,嘉義縣,東石鄉,型厝村,179,53,155,262,24,-209,15.484,-79.771
10010090004,嘉義縣,東石鄉,塭港村,231,68,225,315,6,-247,2.667,-78.413
10010090005,嘉義縣,東石鄉,三家村,143,43,118,207,25,-164,21.186,-79.227
10010090006,嘉義縣,東石鄉,永屯村,129,39,89,119,40,-80,44.944,-67.227
10010090007,嘉義縣,東石鄉,海埔村,57,16,52,84,5,-68,9.615,-80.952
10010090008,嘉義縣,東石鄉,龍港村,160,24,156,141,4,-117,2.564,-82.979
10010090009,嘉義縣,東石鄉,副瀨村,132,42,103,212,29,-170,28.155,-80.189
10010090010,嘉義縣,東石鄉,下揖村,64,49,77,176,-13,-127,-16.883,-72.159
10010090011,嘉義縣,東石鄉,頂揖村,35,20,54,88,-19,-68,-35.185,-77.273
10010090012,嘉義縣,東石鄉,溪下村,108,24,105,157,3,-133,2.857,-84.713
10010090022,嘉義縣,東石鄉,港口村,46,14,32,53,14,-39,43.75,-73.585
10010090023,嘉義縣,東石鄉,鰲鼓村,143,41,132,282,11,-241,8.333,-85.461
10010090013,嘉義縣,東石鄉,港墘村,160,80,164,303,-4,-223,-2.439,-73.597
10010090014,嘉義縣,東石鄉,蔦松村,107,31,93,181,14,-150,15.054,-82.873
10010090015,嘉義縣,東石鄉,圍潭村,86,35,78,142,8,-107,10.256,-75.352
10010090016,嘉義縣,東石鄉,洲仔村,94,33,81,165,13,-132,16.049,-80.0
10010090017,嘉義縣,東石鄉,東崙村,84,23,86,144,-2,-121,-2.326,-84.028
10010090018,嘉義縣,東石鄉,西崙村,163,77,142,269,21,-192,14.789,-71.375
10010090019,嘉義縣,東石鄉,塭仔村,110,63,70,261,40,-198,57.143,-75.862
10010090020,嘉義縣,東石鄉,網寮村,174,54,153,221,21,-167,13.725,-75.566
10010090021,嘉義縣,東石鄉,掌潭村,124,46,130,195,-6,-149,-4.615,-76.41
10010020001,嘉義縣,朴子市,安福里,342,130,338,378,4,-248,1.183,-65.608
10010020002,嘉義縣,朴子市,平和里,423,145,420,526,3,-381,0.714,-72.433
10010020003,嘉義縣,朴子市,內厝里,191,130,176,306,15,-176,8.523,-57.516
10010020004,嘉義縣,朴子市,開元里,64,40,59,118,5,-78,8.475,-66.102
10010020006,嘉義縣,朴子市,中正里,115,62,120,173,-5,-111,-4.167,-64.162
10010020005,嘉義縣,朴子市,順天里,104,49,102,157,2,-108,1.961,-68.79
10010020007,嘉義縣,朴子市,博厚里,165,55,121,205,44,-150,36.364,-73.171
10010020008,嘉義縣,朴子市,文化里,310,115,290,414,20,-299,6.897,-72.222
10010020009,嘉義縣,朴子市,永和里,410,186,304,630,106,-444,34.868,-70.476
10010020010,嘉義縣,朴子市,竹圍里,796,330,756,980,40,-650,5.291,-66.327
10010020011,嘉義縣,朴子市,新寮里,99,40,78,162,21,-122,26.923,-75.309
10010020012,嘉義縣,朴子市,双溪里,68,42,61,128,7,-86,11.475,-67.188
10010020013,嘉義縣,朴子市,溪口里,96,33,89,182,7,-149,7.865,-81.868
10010020014,嘉義縣,朴子市,德興里,108,94,91,319,17,-225,18.681,-70.533
10010020015,嘉義縣,朴子市,仁和里,333,129,265,405,68,-276,25.66,-68.148
10010020016,嘉義縣,朴子市,大鄉里,503,189,394,713,109,-524,27.665,-73.492
10010020017,嘉義縣,朴子市,大葛里,574,160,435,648,139,-488,31.954,-75.309
10010020018,嘉義縣,朴子市,佳禾里,111,61,84,164,27,-103,32.143,-62.805
10010020019,嘉義縣,朴子市,竹村里,200,79,150,260,50,-181,33.333,-69.615
10010020020,嘉義縣,朴子市,崁前里,96,43,104,221,-8,-178,-7.692,-80.543
10010020022,嘉義縣,朴子市,崁後里,95,51,79,192,16,-141,20.253,-73.438
10010020021,嘉義縣,朴子市,順安里,33,20,31,79,2,-59,6.452,-74.684
10010020023,嘉義縣,朴子市,德家里,87,52,72,189,15,-137,20.833,-72.487
10010020024,嘉義縣,朴子市,新庄里,96,43,114,154,-18,-111,-15.789,-72.078
10010020025,嘉義縣,朴子市,梅華里,122,74,84,332,38,-258,45.238,-77.711
10010020026,嘉義縣,朴子市,松華里,106,103,93,330,13,-227,13.978,-68.788
10010020027,嘉義縣,朴子市,南竹里,53,54,31,166,22,-112,70.968,-67.47
10010010001,嘉義縣,太保市,太保里,454,129,393,479,61,-350,15.522,-73.069
10010010002,嘉義縣,太保市,後庄里,51,32,41,148,10,-116,24.39,-78.378
10010010003,嘉義縣,太保市,前潭里,193,86,195,423,-2,-337,-1.026,-79.669
10010010004,嘉義縣,太保市,後潭里,250,91,271,458,-21,-367,-7.749,-80.131
10010010005,嘉義縣,太保市,梅埔里,207,41,174,296,33,-255,18.966,-86.149
10010010006,嘉義縣,太保市,春珠里,195,87,119,262,76,-175,63.866,-66.794
10010010007,嘉義縣,太保市,崙頂里,158,40,127,203,31,-163,24.409,-80.296
10010010018,嘉義縣,太保市,安仁里,508,124,481,560,27,-436,5.613,-77.857
10010010008,嘉義縣,太保市,東勢里,368,118,323,443,45,-325,13.932,-73.363
10010010009,嘉義縣,太保市,新埤里,215,82,143,345,72,-263,50.35,-76.232
10010010010,嘉義縣,太保市,舊埤里,479,186,483,426,-4,-240,-0.828,-56.338
10010010011,嘉義縣,太保市,田尾里,117,38,100,192,17,-154,17.0,-80.208
10010010012,嘉義縣,太保市,港尾里,122,32,80,139,42,-107,52.5,-76.978
10010010013,嘉義縣,太保市,過溝里,664,242,478,918,186,-676,38.912,-73.638
10010010014,嘉義縣,太保市,麻寮里,836,264,597,1080,239,-816,40.034,-75.556
10010010015,嘉義縣,太保市,南新里,267,129,210,502,57,-373,27.143,-74.303
10010010016,嘉義縣,太保市,北新里,573,199,386,728,187,-529,48.446,-72.665
10010010017,嘉義縣,太保市,埤鄉里,116,51,105,167,11,-116,10.476,-69.461
10010030001,嘉義縣,布袋鎮,岱江里,101,32,114,116,-13,-84,-11.404,-72.414
10010030002,嘉義縣,布袋鎮,九龍里,59,11,66,78,-7,-67,-10.606,-85.897
10010030003,嘉義縣,布袋鎮,岑海里,343,106,353,439,-10,-333,-2.833,-75.854
10010030004,嘉義縣,布袋鎮,興中里,170,54,161,223,9,-169,5.59,-75.785
10010030005,嘉義縣,布袋鎮,光復里,328,132,303,378,25,-246,8.251,-65.079
10010030006,嘉義縣,布袋鎮,見龍里,121,51,107,195,14,-144,13.084,-73.846
10010030007,嘉義縣,布袋鎮,新厝里,131,25,92,105,39,-80,42.391,-76.19
10010030008,嘉義縣,布袋鎮,龍江里,105,41,101,128,4,-87,3.96,-67.969
10010030018,嘉義縣,布袋鎮,振寮里,138,30,127,113,11,-83,8.661,-73.451
10010030019,嘉義縣,布袋鎮,西安里,151,72,154,266,-3,-194,-1.948,-72.932
10010030021,嘉義縣,布袋鎮,中安里,133,99,132,340,1,-241,0.758,-70.882
10010030020,嘉義縣,布袋鎮,東安里,163,93,153,386,10,-293,6.536,-75.907
10010030022,嘉義縣,布袋鎮,樹林里,81,49,65,129,16,-80,24.615,-62.016
10010030023,嘉義縣,布袋鎮,貴舍里,59,40,57,180,2,-140,3.509,-77.778
10010030013,嘉義縣,布袋鎮,永安里,161,50,165,196,-4,-146,-2.424,-74.49
10010030014,嘉義縣,布袋鎮,東港里,269,114,228,457,41,-343,17.982,-75.055
10010030015,嘉義縣,布袋鎮,江山里,47,10,49,56,-2,-46,-4.082,-82.143
10010030016,嘉義縣,布袋鎮,菜舖里,66,17,56,82,10,-65,17.857,-79.268
10010030017,嘉義縣,布袋鎮,考試里,43,29,41,85,2,-56,4.878,-65.882
10010030009,嘉義縣,布袋鎮,新岑里,97,43,116,273,-19,-230,-16.379,-84.249
10010030010,嘉義縣,布袋鎮,新民里,147,61,138,244,9,-183,6.522,-75.0
10010030011,嘉義縣,布袋鎮,復興里,315,108,266,493,49,-385,18.421,-78.093
10010030012,嘉義縣,布袋鎮,好美里,126,30,106,226,20,-196,18.868,-86.726
10010100001,嘉義縣,義竹鄉,岸腳村,93,34,87,173,6,-139,6.897,-80.347
10010100002,嘉義縣,義竹鄉,義竹村,208,107,194,411,14,-304,7.216,-73.966
10010100003,嘉義縣,義竹鄉,六桂村,209,54,196,257,13,-203,6.633,-78.988
10010100004,嘉義縣,義竹鄉,仁里村,139,60,158,196,-19,-136,-12.025,-69.388
10010100005,嘉義縣,義竹鄉,傳芳村,98,41,101,179,-3,-138,-2.97,-77.095
10010100006,嘉義縣,義竹鄉,頭竹村,136,76,143,321,-7,-245,-4.895,-76.324
10010100007,嘉義縣,義竹鄉,五厝村,47,19,53,95,-6,-76,-11.321,-80.0
10010100008,嘉義縣,義竹鄉,中平村,76,26,77,94,-1,-68,-1.299,-72.34
10010100009,嘉義縣,義竹鄉,埤前村,136,26,122,199,14,-173,11.475,-86.935
10010100010,嘉義縣,義竹鄉,平溪村,57,14,58,115,-1,-101,-1.724,-87.826
10010100011,嘉義縣,義竹鄉,後鎮村,71,20,82,101,-11,-81,-13.415,-80.198
10010100012,嘉義縣,義竹鄉,北華村,85,42,95,152,-10,-110,-10.526,-72.368
10010100013,嘉義縣,義竹鄉,新店村,205,72,182,297,23,-225,12.637,-75.758
10010100014,嘉義縣,義竹鄉,東過村,97,31,91,150,6,-119,6.593,-79.333
10010100015,嘉義縣,義竹鄉,西過村,80,25,74,186,6,-161,8.108,-86.559
10010100016,嘉義縣,義竹鄉,官和村,70,31,57,230,13,-199,22.807,-86.522
10010100017,嘉義縣,義竹鄉,官順村,32,15,52,95,-20,-80,-38.462,-84.211
10010100018,嘉義縣,義竹鄉,新富村,65,21,93,89,-28,-68,-30.108,-76.404
10010100019,嘉義縣,義竹鄉,東光村,93,47,89,203,4,-156,4.494,-76.847
10010100020,嘉義縣,義竹鄉,東榮村,52,33,51,100,1,-67,1.961,-67.0
10010100021,嘉義縣,義竹鄉,龍蛟村,58,38,69,130,-11,-92,-15.942,-70.769
10010100022,嘉義縣,義竹鄉,溪洲村,92,65,79,216,13,-151,16.456,-69.907
10010110001,嘉義縣,鹿草鄉,後寮村,47,32,44,134,3,-102,6.818,-76.119
10010110002,嘉義縣,鹿草鄉,鹿東村,62,40,59,159,3,-119,5.085,-74.843
10010110003,嘉義縣,鹿草鄉,鹿草村,198,74,154,308,44,-234,28.571,-75.974
10010110004,嘉義縣,鹿草鄉,西井村,182,83,190,285,-8,-202,-4.211,-70.877
10010110005,嘉義縣,鹿草鄉,豊稠村,90,20,82,98,8,-78,9.756,-79.592
10010110006,嘉義縣,鹿草鄉,重寮村,127,74,112,284,15,-210,13.393,-73.944
10010110007,嘉義縣,鹿草鄉,施家村,46,33,42,114,4,-81,9.524,-71.053
10010110008,嘉義縣,鹿草鄉,下潭村,70,64,72,255,-2,-191,-2.778,-74.902
10010110009,嘉義縣,鹿草鄉,光潭村,97,78,89,294,8,-216,8.989,-73.469
10010110010,嘉義縣,鹿草鄉,碧潭村,132,39,132,198,0,-159,0.0,-80.303
10010110011,嘉義縣,鹿草鄉,松竹村,108,38,119,176,-11,-138,-9.244,-78.409
10010110012,嘉義縣,鹿草鄉,竹山村,118,44,87,256,31,-212,35.632,-82.812
10010110013,嘉義縣,鹿草鄉,後堀村,178,65,149,287,29,-222,19.463,-77.352
10010110014,嘉義縣,鹿草鄉,三角村,251,104,174,402,77,-298,44.253,-74.129
10010110015,嘉義縣,鹿草鄉,下麻村,103,45,112,165,-9,-120,-8.036,-72.727
10010120001,嘉義縣,水上鄉,水上村,813,275,671,955,142,-680,21.162,-71.204
10010120002,嘉義縣,水上鄉,水頭村,517,154,468,585,49,-431,10.47,-73.675
10010120006,嘉義縣,水上鄉,粗溪村,292,95,270,340,22,-245,8.148,-72.059
10010120007,嘉義縣,水上鄉,下寮村,395,130,303,445,92,-315,30.363,-70.787
10010120008,嘉義縣,水上鄉,三和村,321,92,309,369,12,-277,3.883,-75.068
10010120009,嘉義縣,水上鄉,回歸村,92,30,86,96,6,-66,6.977,-68.75
10010120003,嘉義縣,水上鄉,大堀村,288,196,225,552,63,-356,28.0,-64.493
10010120004,嘉義縣,水上鄉,大崙村,347,119,264,522,83,-403,31.439,-77.203
10010120005,嘉義縣,水上鄉,塗溝村,117,60,98,246,19,-186,19.388,-75.61
10010120013,嘉義縣,水上鄉,龍德村,288,145,233,602,55,-457,23.605,-75.914
10010120014,嘉義縣,水上鄉,溪洲村,163,105,151,274,12,-169,7.947,-61.679
10010120010,嘉義縣,水上鄉,三鎮村,129,40,139,102,-10,-62,-7.194,-60.784
10010120011,嘉義縣,水上鄉,靖和村,105,49,91,123,14,-74,15.385,-60.163
10010120012,嘉義縣,水上鄉,南和村,215,105,174,345,41,-240,23.563,-69.565
10010120017,嘉義縣,水上鄉,柳新村,364,98,313,372,51,-274,16.294,-73.656
10010120015,嘉義縣,水上鄉,柳林村,346,139,264,449,82,-310,31.061,-69.042
10010120016,嘉義縣,水上鄉,柳鄉村,295,141,264,530,31,-389,11.742,-73.396
10010120025,嘉義縣,水上鄉,內溪村,237,80,171,263,66,-183,38.596,-69.582
10010120018,嘉義縣,水上鄉,寬士村,656,315,621,1027,35,-712,5.636,-69.328
10010120019,嘉義縣,水上鄉,民生村,530,230,501,707,29,-477,5.788,-67.468
10010120026,嘉義縣,水上鄉,義興村,145,70,117,189,28,-119,23.932,-62.963
10010120021,嘉義縣,水上鄉,中庄村,301,115,257,387,44,-272,17.121,-70.284
10010120020,嘉義縣,水上鄉,忠和村,295,118,308,403,-13,-285,-4.221,-70.72
10010120022,嘉義縣,水上鄉,南鄉村,124,52,125,213,-1,-161,-0.8,-75.587
10010120023,嘉義縣,水上鄉,三界村,138,87,135,245,3,-158,2.222,-64.49
10010120024,嘉義縣,水上鄉,國姓村,128,66,130,295,-2,-229,-1.538,-77.627
10010060001,嘉義縣,溪口鄉,溪東村,211,89,189,323,22,-234,11.64,-72.446
10010060002,嘉義縣,溪口鄉,溪西村,94,40,103,188,-9,-148,-8.738,-78.723
10010060003,嘉義縣,溪口鄉,溪北村,86,24,71,162,15,-138,21.127,-85.185
10010060011,嘉義縣,溪口鄉,柳溝村,197,79,158,343,39,-264,24.684,-76.968
10010060012,嘉義縣,溪口鄉,疊溪村,183,82,115,278,68,-196,59.13,-70.504
10010060013,嘉義縣,溪口鄉,妙崙村,110,44,76,165,34,-121,44.737,-73.333
10010060014,嘉義縣,溪口鄉,坪頂村,127,65,100,259,27,-194,27.0,-74.903
10010060006,嘉義縣,溪口鄉,柴林村,80,56,73,208,7,-152,9.589,-73.077
10010060007,嘉義縣,溪口鄉,林腳村,93,36,60,200,33,-164,55.0,-82.0
10010060008,嘉義縣,溪口鄉,美南村,124,64,86,276,38,-212,44.186,-76.812
10010060009,嘉義縣,溪口鄉,美北村,149,62,100,230,49,-168,49.0,-73.043
10010060010,嘉義縣,溪口鄉,本厝村,164,50,123,245,41,-195,33.333,-79.592
10010060005,嘉義縣,溪口鄉,游西村,64,57,52,208,12,-151,23.077,-72.596
10010060004,嘉義縣,溪口鄉,游東村,110,94,97,297,13,-203,13.402,-68.35
10010040001,嘉義縣,大林鎮,東林里,90,50,79,137,11,-87,13.924,-63.504
10010040002,嘉義縣,大林鎮,西林里,359,158,326,488,33,-330,10.123,-67.623
10010040003,嘉義縣,大林鎮,吉林里,204,64,173,211,31,-147,17.919,-69.668
10010040004,嘉義縣,大林鎮,平林里,1177,415,1045,1331,132,-916,12.632,-68.82
10010040005,嘉義縣,大林鎮,明華里,180,74,167,310,13,-236,7.784,-76.129
10010040006,嘉義縣,大林鎮,明和里,381,124,306,349,75,-225,24.51,-64.47
10010040007,嘉義縣,大林鎮,排路里,89,54,65,203,24,-149,36.923,-73.399
10010040008,嘉義縣,大林鎮,西結里,77,46,58,202,19,-156,32.759,-77.228
10010040009,嘉義縣,大林鎮,湖北里,88,63,82,182,6,-119,7.317,-65.385
10010040010,嘉義縣,大林鎮,大糖里,36,11,41,33,-5,-22,-12.195,-66.667
10010040011,嘉義縣,大林鎮,大美里,273,78,242,308,31,-230,12.81,-74.675
10010040012,嘉義縣,大林鎮,過溪里,221,108,193,330,28,-222,14.508,-67.273
10010040013,嘉義縣,大林鎮,中坑里,214,100,195,330,19,-230,9.744,-69.697
10010040014,嘉義縣,大林鎮,上林里,144,31,133,184,11,-153,8.271,-83.152
10010040015,嘉義縣,大林鎮,中林里,225,132,190,453,35,-321,18.421,-70.861
10010040016,嘉義縣,大林鎮,三和里,371,130,310,423,61,-293,19.677,-69.267
10010040017,嘉義縣,大林鎮,溝背里,159,52,126,220,33,-168,26.19,-76.364
10010040018,嘉義縣,大林鎮,義和里,158,46,123,131,35,-85,28.455,-64.885
10010040019,嘉義縣,大林鎮,內林里,132,35,117,154,15,-119,12.821,-77.273
10010040020,嘉義縣,大林鎮,三角里,155,38,132,163,23,-125,17.424,-76.687
10010040021,嘉義縣,大林鎮,三村里,160,38,146,195,14,-157,9.589,-80.513
10010150001,嘉義縣,梅山鄉,梅東村,348,130,311,494,37,-364,11.897,-73.684
10010150002,嘉義縣,梅山鄉,梅南村,177,51,167,185,10,-134,5.988,-72.432
10010150004,嘉義縣,梅山鄉,梅北村,739,249,610,931,129,-682,21.148,-73.255
10010150003,嘉義縣,梅山鄉,過山村,89,41,64,130,25,-89,39.062,-68.462
10010150005,嘉義縣,梅山鄉,圳南村,64,17,57,90,7,-73,12.281,-81.111
10010150008,嘉義縣,梅山鄉,圳北村,108,39,73,108,35,-69,47.945,-63.889
10010150010,嘉義縣,梅山鄉,双溪村,94,25,78,127,16,-102,20.513,-80.315
10010150009,嘉義縣,梅山鄉,大南村,271,80,216,340,55,-260,25.463,-76.471
10010150011,嘉義縣,梅山鄉,安靖村,108,25,90,135,18,-110,20.0,-81.481
10010150006,嘉義縣,梅山鄉,永興村,95,30,77,105,18,-75,23.377,-71.429
10010150007,嘉義縣,梅山鄉,半天村,58,20,39,69,19,-49,48.718,-71.014
10010150012,嘉義縣,梅山鄉,太平村,96,26,65,74,31,-48,47.692,-64.865
10010150014,嘉義縣,梅山鄉,太興村,96,15,88,65,8,-50,9.091,-76.923
10010150018,嘉義縣,梅山鄉,龍眼村,66,23,31,93,35,-70,112.903,-75.269
10010150013,嘉義縣,梅山鄉,碧湖村,61,11,38,45,23,-34,60.526,-75.556
10010150015,嘉義縣,梅山鄉,瑞峯村,138,22,109,97,29,-75,26.606,-77.32
10010150016,嘉義縣,梅山鄉,瑞里村,128,20,114,68,14,-48,12.281,-70.588
10010150017,嘉義縣,梅山鄉,太和村,161,34,92,145,69,-111,75.0,-76.552
10010070001,嘉義縣,新港鄉,宮前村,419,142,417,566,2,-424,0.48,-74.912
10010070002,嘉義縣,新港鄉,宮後村,221,126,215,438,6,-312,2.791,-71.233
10010070003,嘉義縣,新港鄉,大興村,217,107,204,382,13,-275,6.373,-71.99
10010070004,嘉義縣,新港鄉,福德村,268,106,235,397,33,-291,14.043,-73.3
10010070005,嘉義縣,新港鄉,古民村,163,91,107,421,56,-330,52.336,-78.385
10010070006,嘉義縣,新港鄉,中庄村,196,132,162,479,34,-347,20.988,-72.443
10010070007,嘉義縣,新港鄉,大潭村,198,118,164,467,34,-349,20.732,-74.732
10010070008,嘉義縣,新港鄉,西庄村,125,63,131,247,-6,-184,-4.58,-74.494
10010070009,嘉義縣,新港鄉,埤子村,64,59,49,166,15,-107,30.612,-64.458
10010070010,嘉義縣,新港鄉,南崙村,78,96,45,312,33,-216,73.333,-69.231
10010070011,嘉義縣,新港鄉,北崙村,24,30,27,141,-3,-111,-11.111,-78.723
10010070012,嘉義縣,新港鄉,海瀛村,81,26,59,136,22,-110,37.288,-80.882
10010070013,嘉義縣,新港鄉,月眉村,188,172,177,574,11,-402,6.215,-70.035
10010070014,嘉義縣,新港鄉,月潭村,205,122,140,448,65,-326,46.429,-72.768
10010070015,嘉義縣,新港鄉,溪北村,173,98,132,377,41,-279,31.061,-74.005
10010070018,嘉義縣,新港鄉,菜公村,173,71,125,247,48,-176,38.4,-71.255
10010070017,嘉義縣,新港鄉,中洋村,160,64,156,249,4,-185,2.564,-74.297
10010070016,嘉義縣,新港鄉,三間村,296,104,212,342,84,-238,39.623,-69.591
10010070019,嘉義縣,新港鄉,安和村,114,56,83,271,31,-215,37.349,-79.336
10010070020,嘉義縣,新港鄉,潭大村,132,69,132,296,0,-227,0.0,-76.689
10010070021,嘉義縣,新港鄉,南港村,151,65,111,273,40,-208,36.036,-76.19
10010070022,嘉義縣,新港鄉,板頭村,91,51,65,141,26,-90,40.0,-63.83
10010070023,嘉義縣,新港鄉,共和村,111,64,88,240,23,-176,26.136,-73.333
10010050001,嘉義縣,民雄鄉,東榮村,441,159,416,523,25,-364,6.01,-69.598
10010050002,嘉義縣,民雄鄉,中樂村,317,124,313,363,4,-239,1.278,-65.84
10010050003,嘉義縣,民雄鄉,西安村,588,246,537,858,51,-612,9.497,-71.329
10010050004,嘉義縣,民雄鄉,寮頂村,427,171,321,551,106,-380,33.022,-68.966
10010050005,嘉義縣,民雄鄉,福權村,262,144,217,460,45,-316,20.737,-68.696
10010050006,嘉義縣,民雄鄉,東湖村,313,93,256,387,57,-294,22.266,-75.969
10010050007,嘉義縣,民雄鄉,頂崙村,255,89,223,344,32,-255,14.35,-74.128
10010050008,嘉義縣,民雄鄉,菁埔村,213,121,164,526,49,-405,29.878,-76.996
10010050009,嘉義縣,民雄鄉,中和村,204,69,153,212,51,-143,33.333,-67.453
10010050010,嘉義縣,民雄鄉,平和村,161,59,119,230,42,-171,35.294,-74.348
10010050011,嘉義縣,民雄鄉,西昌村,131,80,99,246,32,-166,32.323,-67.48
10010050012,嘉義縣,民雄鄉,豊收村,419,160,359,476,60,-316,16.713,-66.387
10010050013,嘉義縣,民雄鄉,三興村,295,129,252,348,43,-219,17.063,-62.931
10010050014,嘉義縣,民雄鄉,東興村,91,29,75,132,16,-103,21.333,-78.03
10010050015,嘉義縣,民雄鄉,鎮北村,289,96,179,275,110,-179,61.453,-65.091
10010050022,嘉義縣,民雄鄉,北斗村,999,304,770,1163,229,-859,29.74,-73.861
10010050023,嘉義縣,民雄鄉,双福村,485,199,439,516,46,-317,10.478,-61.434
10010050028,嘉義縣,民雄鄉,福樂村,1292,462,1041,1530,251,-1068,24.111,-69.804
10010050024,嘉義縣,民雄鄉,大崎村,452,149,365,519,87,-370,23.836,-71.291
10010050025,嘉義縣,民雄鄉,秀林村,446,226,305,724,141,-498,46.23,-68.785
10010050026,嘉義縣,民雄鄉,松山村,265,92,213,377,52,-285,24.413,-75.597
10010050016,嘉義縣,民雄鄉,興中村,289,123,247,424,42,-301,17.004,-70.991
10010050017,嘉義縣,民雄鄉,興南村,468,182,372,561,96,-379,25.806,-67.558
10010050027,嘉義縣,民雄鄉,金興村,566,213,448,686,118,-473,26.339,-68.95
10010050018,嘉義縣,民雄鄉,福興村,349,186,305,548,44,-362,14.426,-66.058
10010050019,嘉義縣,民雄鄉,文隆村,534,163,431,561,103,-398,23.898,-70.945
10010050020,嘉義縣,民雄鄉,山中村,648,292,470,911,178,-619,37.872,-67.947
10010050021,嘉義縣,民雄鄉,中央村,179,102,154,360,25,-258,16.234,-71.667
10010140001,嘉義縣,竹崎鄉,竹崎村,433,135,398,569,35,-434,8.794,-76.274
10010140002,嘉義縣,竹崎鄉,和平村,353,99,253,475,100,-376,39.526,-79.158
10010140003,嘉義縣,竹崎鄉,坑頭村,116,36,91,143,25,-107,27.473,-74.825
10010140004,嘉義縣,竹崎鄉,沙坑村,105,73,76,231,29,-158,38.158,-68.398
10010140005,嘉義縣,竹崎鄉,獅埜村,199,78,154,348,45,-270,29.221,-77.586
10010140006,嘉義縣,竹崎鄉,義和村,132,59,111,184,21,-125,18.919,-67.935
10010140007,嘉義縣,竹崎鄉,義仁村,155,57,104,204,51,-147,49.038,-72.059
10010140008,嘉義縣,竹崎鄉,灣橋村,988,330,882,1104,106,-774,12.018,-70.109
10010140009,嘉義縣,竹崎鄉,鹿滿村,251,98,192,358,59,-260,30.729,-72.626
10010140010,嘉義縣,竹崎鄉,紫雲村,207,62,197,271,10,-209,5.076,-77.122
10010140011,嘉義縣,竹崎鄉,內埔村,247,105,218,399,29,-294,13.303,-73.684
10010140012,嘉義縣,竹崎鄉,昇平村,221,51,165,324,56,-273,33.939,-84.259
10010140014,嘉義縣,竹崎鄉,桃源村,131,26,123,187,8,-161,6.504,-86.096
10010140013,嘉義縣,竹崎鄉,白杞村,73,20,72,103,1,-83,1.389,-80.583
10010140015,嘉義縣,竹崎鄉,塘興村,161,37,138,160,23,-123,16.667,-76.875
10010140016,嘉義縣,竹崎鄉,義隆村,113,35,80,133,33,-98,41.25,-73.684
10010140017,嘉義縣,竹崎鄉,龍山村,218,92,184,419,34,-327,18.478,-78.043
10010140018,嘉義縣,竹崎鄉,文峯村,80,27,82,137,-2,-110,-2.439,-80.292
10010140019,嘉義縣,竹崎鄉,金獅村,62,16,63,94,-1,-78,-1.587,-82.979
10010140020,嘉義縣,竹崎鄉,復金村,313,96,219,414,94,-318,42.922,-76.812
10010140021,嘉義縣,竹崎鄉,緞繻村,127,26,125,147,2,-121,1.6,-82.313
10010140022,嘉義縣,竹崎鄉,仁壽村,12,12,15,51,-3,-39,-20.0,-76.471
10010140023,嘉義縣,竹崎鄉,中和村,132,26,87,154,45,-128,51.724,-83.117
10010140024,嘉義縣,竹崎鄉,光華村,99,31,99,107,0,-76,0.0,-71.028
10010130006,嘉義縣,中埔鄉,富收村,466,191,398,661,68,-470,17.085,-71.104
10010130007,嘉義縣,中埔鄉,和睦村,552,189,476,758,76,-569,15.966,-75.066
10010130008,嘉義縣,中埔鄉,和美村,1276,487,1116,1548,160,-1061,14.337,-68.54
10010130009,嘉義縣,中埔鄉,和興村,921,356,782,1243,139,-887,17.775,-71.36
10010130001,嘉義縣,中埔鄉,中埔村,274,85,232,380,42,-295,18.103,-77.632
10010130002,嘉義縣,中埔鄉,塩舘村,172,51,144,228,28,-177,19.444,-77.632
10010130005,嘉義縣,中埔鄉,金蘭村,228,77,185,275,43,-198,23.243,-72.0
10010130010,嘉義縣,中埔鄉,隆興村,288,111,252,394,36,-283,14.286,-71.827
10010130011,嘉義縣,中埔鄉,義仁村,204,85,153,361,51,-276,33.333,-76.454
10010130012,嘉義縣,中埔鄉,社口村,344,87,271,445,73,-358,26.937,-80.449
10010130013,嘉義縣,中埔鄉,灣潭村,143,52,112,209,31,-157,27.679,-75.12
10010130004,嘉義縣,中埔鄉,裕民村,96,77,84,258,12,-181,14.286,-70.155
10010130003,嘉義縣,中埔鄉,龍門村,132,35,124,198,8,-163,6.452,-82.323
10010130014,嘉義縣,中埔鄉,石硦村,218,32,155,256,63,-224,40.645,-87.5
10010130015,嘉義縣,中埔鄉,頂埔村,136,56,101,241,35,-185,34.653,-76.763
10010130016,嘉義縣,中埔鄉,同仁村,305,104,217,440,88,-336,40.553,-76.364
10010130020,嘉義縣,中埔鄉,深坑村,124,43,106,153,18,-110,16.981,-71.895
10010130019,嘉義縣,中埔鄉,三層村,70,43,58,138,12,-95,20.69,-68.841
10010130017,嘉義縣,中埔鄉,瑞豐村,133,29,97,127,36,-98,37.113,-77.165
10010130018,嘉義縣,中埔鄉,沄水村,151,46,118,221,33,-175,27.966,-79.186
10010130021,嘉義縣,中埔鄉,東興村,86,15,68,87,18,-72,26.471,-82.759
10010130022,嘉義縣,中埔鄉,中崙村,62,9,48,54,14,-45,29.167,-83.333
10010160001,嘉義縣,番路鄉,江西村,238,66,226,211,12,-145,5.31,-68.72
10010160002,嘉義縣,番路鄉,內甕村,66,30,78,90,-12,-60,-15.385,-66.667
10010160003,嘉義縣,番路鄉,新福村,194,75,159,251,35,-176,22.013,-70.12
10010160004,嘉義縣,番路鄉,下坑村,340,87,288,383,52,-296,18.056,-77.285
10010160005,嘉義縣,番路鄉,番路村,147,53,118,176,29,-123,24.576,-69.886
10010160006,嘉義縣,番路鄉,民和村,151,30,141,171,10,-141,7.092,-82.456
10010160007,嘉義縣,番路鄉,觸口村,187,75,175,234,12,-159,6.857,-67.949
10010160008,嘉義縣,番路鄉,大湖村,68,29,56,101,12,-72,21.429,-71.287
10010160009,嘉義縣,番路鄉,公田村,169,23,117,134,52,-111,44.444,-82.836
10010160010,嘉義縣,番路鄉,公興村,62,24,58,89,4,-65,6.897,-73.034
10010160011,嘉義縣,番路鄉,草山村,65,9,63,34,2,-25,3.175,-73.529
10010180001,嘉義縣,阿里山鄉,中山村,73,24,61,50,12,-26,19.672,-52.0
10010180002,嘉義縣,阿里山鄉,中正村,31,4,45,18,-14,-14,-31.111,-77.778
10010180003,嘉義縣,阿里山鄉,香林村,31,6,28,14,3,-8,10.714,-57.143
10010180004,嘉義縣,阿里山鄉,十字村,73,7,50,33,23,-26,46.0,-78.788
10010180006,嘉義縣,阿里山鄉,豐山村,61,5,51,31,10,-26,19.608,-83.871
10010180005,嘉義縣,阿里山鄉,來吉村,79,12,95,33,-16,-21,-16.842,-63.636
10010180008,嘉義縣,阿里山鄉,樂野村,184,27,177,122,7,-95,3.955,-77.869
10010180007,嘉義縣,阿里山鄉,達邦村,178,12,195,52,-17,-40,-8.718,-76.923
10010180009,嘉義縣,阿里山鄉,里佳村,60,7,65,21,-5,-14,-7.692,-66.667
10010180010,嘉義縣,阿里山鄉,山美村,127,15,98,32,29,-17,29.592,-53.125
10010180011,嘉義縣,阿里山鄉,新美村,62,7,68,25,-6,-18,-8.824,-72.0
10010180012,嘉義縣,阿里山鄉,茶山村,47,11,35,47,12,-36,34.286,-76.596
10010170001,嘉義縣,大埔鄉,大埔村,136,43,135,218,1,-175,0.741,-80.275
10010170002,嘉義縣,大埔鄉,和平村,52,21,60,110,-8,-89,-13.333,-80.909
10010170003,嘉義縣,大埔鄉,永樂村,43,8,62,54,-19,-46,-30.645,-85.185
10010170004,嘉義縣,大埔鄉,茄苳村,112,9,80,104,32,-95,40.0,-91.346
10010170005,嘉義縣,大埔鄉,西興村,60,12,88,87,-28,-75,-31.818,-86.207
10014010023,臺東縣,臺東市,文化里,296,63,138,104,158,-41,114.493,-39.423
10014010015,臺東縣,臺東市,中華里,450,105,311,252,139,-147,44.695,-58.333
10014010024,臺東縣,臺東市,中山里,354,98,179,137,175,-39,97.765,-28.467
10014010020,臺東縣,臺東市,中正里,484,145,184,162,300,-17,163.043,-10.494
10014010022,臺東縣,臺東市,成功里,393,97,146,144,247,-47,169.178,-32.639
10014010017,臺東縣,臺東市,建國里,368,66,226,172,142,-106,62.832,-61.628
10014010013,臺東縣,臺東市,民族里,466,119,263,217,203,-98,77.186,-45.161
10014010012,臺東縣,臺東市,自強里,745,163,982,608,-237,-445,-24.134,-73.191
10014010011,臺東縣,臺東市,中心里,656,141,772,427,-116,-286,-15.026,-66.979
10014010010,臺東縣,臺東市,馬蘭里,551,84,650,292,-99,-208,-15.231,-71.233
10014010008,臺東縣,臺東市,民生里,705,161,723,552,-18,-391,-2.49,-70.833
10014010009,臺東縣,臺東市,寶桑里,254,91,164,137,90,-46,54.878,-33.577
10014010047,臺東縣,臺東市,仁和里,736,131,,,,,,
10014010007,臺東縣,臺東市,新生里,786,150,1511,815,-725,-665,-47.981,-81.595
10014010006,臺東縣,臺東市,南榮里,636,92,604,294,32,-202,5.298,-68.707
10014010003,臺東縣,臺東市,岩灣里,543,75,496,265,47,-190,9.476,-71.698
10014010005,臺東縣,臺東市,卑南里,715,162,692,545,23,-383,3.324,-70.275
10014010004,臺東縣,臺東市,南王里,626,100,598,293,28,-193,4.682,-65.87
10014010001,臺東縣,臺東市,富岡里,465,75,315,136,150,-61,47.619,-44.853
10014010037,臺東縣,臺東市,新興里,269,66,192,135,77,-69,40.104,-51.111
10014010036,臺東縣,臺東市,東海里,531,105,660,368,-129,-263,-19.545,-71.467
10014010033,臺東縣,臺東市,豐樂里,394,68,307,183,87,-115,28.339,-62.842
10014010032,臺東縣,臺東市,光明里,621,111,638,337,-17,-226,-2.665,-67.062
10014010031,臺東縣,臺東市,豐年里,605,119,614,348,-9,-229,-1.466,-65.805
10014010035,臺東縣,臺東市,康樂里,299,54,234,158,65,-104,27.778,-65.823
10014010034,臺東縣,臺東市,永樂里,505,98,448,276,57,-178,12.723,-64.493
10014010048,臺東縣,臺東市,豐安里,655,121,,,,,,
10014010038,臺東縣,臺東市,豐榮里,678,125,1891,1008,-1213,-883,-64.146,-87.599
10014010049,臺東縣,臺東市,豐盛里,871,169,,,,,,
10014010039,臺東縣,臺東市,豐谷里,729,107,1020,476,-291,-369,-28.529,-77.521
10014010040,臺東縣,臺東市,豐里里,420,110,414,336,6,-226,1.449,-67.262
10014010041,臺東縣,臺東市,豐原里,226,65,209,205,17,-140,8.134,-68.293
10014010030,臺東縣,臺東市,豐田里,475,121,397,331,78,-210,19.647,-63.444
10014010029,臺東縣,臺東市,新園里,380,53,351,192,29,-139,8.262,-72.396
10014010042,臺東縣,臺東市,建和里,277,38,316,151,-39,-113,-12.342,-74.834
10014010043,臺東縣,臺東市,建興里,262,75,190,154,72,-79,37.895,-51.299
10014010045,臺東縣,臺東市,知本里,532,119,284,174,248,-55,87.324,-31.609
10014010046,臺東縣,臺東市,建農里,419,43,429,141,-10,-98,-2.331,-69.504
10014020008,臺東縣,成功鎮,信義里,360,59,398,103,-38,-44,-9.548,-42.718
10014020007,臺東縣,成功鎮,和平里,130,28,139,49,-9,-21,-6.475,-42.857
10014020006,臺東縣,成功鎮,忠仁里,410,67,410,225,0,-158,0.0,-70.222
10014020005,臺東縣,成功鎮,忠智里,371,57,398,180,-27,-123,-6.784,-68.333
10014020004,臺東縣,成功鎮,三民里,502,73,505,150,-3,-77,-0.594,-51.333
10014020003,臺東縣,成功鎮,三仙里,243,34,220,83,23,-49,10.455,-59.036
10014020002,臺東縣,成功鎮,忠孝里,133,41,156,72,-23,-31,-14.744,-43.056
10014020001,臺東縣,成功鎮,博愛里,152,17,166,36,-14,-19,-8.434,-52.778
10014030005,臺東縣,關山鎮,里壠里,301,38,387,140,-86,-102,-22.222,-72.857
10014030004,臺東縣,關山鎮,中福里,154,34,189,123,-35,-89,-18.519,-72.358
10014030003,臺東縣,關山鎮,新福里,140,22,175,107,-35,-85,-20.0,-79.439
10014030002,臺東縣,關山鎮,豐泉里,225,41,263,115,-38,-74,-14.449,-64.348
10014030007,臺東縣,關山鎮,月眉里,79,14,107,80,-28,-66,-26.168,-82.5
10014030001,臺東縣,關山鎮,德高里,294,46,300,152,-6,-106,-2.0,-69.737
10014030006,臺東縣,關山鎮,電光里,63,20,114,50,-51,-30,-44.737,-60.0
10014040008,臺東縣,卑南鄉,賓朗村,425,81,408,319,17,-238,4.167,-74.608
10014040007,臺東縣,卑南鄉,美農村,159,54,171,187,-12,-133,-7.018,-71.123
10014040006,臺東縣,卑南鄉,初鹿村,241,44,224,141,17,-97,7.589,-68.794
10014040005,臺東縣,卑南鄉,明峰村,197,55,187,154,10,-99,5.348,-64.286
10014040001,臺東縣,卑南鄉,嘉豐村,70,22,83,52,-13,-30,-15.663,-57.692
10014040010,臺東縣,卑南鄉,太平村,696,117,669,326,27,-209,4.036,-64.11
10014040009,臺東縣,卑南鄉,泰安村,243,37,211,113,32,-76,15.166,-67.257
10014040011,臺東縣,卑南鄉,利嘉村,274,43,302,101,-28,-58,-9.272,-57.426
10014040012,臺東縣,卑南鄉,東興村,361,24,327,63,34,-39,10.398,-61.905
10014040013,臺東縣,卑南鄉,溫泉村,190,59,126,219,64,-160,50.794,-73.059
10014040003,臺東縣,卑南鄉,富山村,101,13,115,37,-14,-24,-12.174,-64.865
10014040004,臺東縣,卑南鄉,富源村,62,13,58,60,4,-47,6.897,-78.333
10014040002,臺東縣,卑南鄉,利吉村,118,14,115,39,3,-25,2.609,-64.103
10014050006,臺東縣,鹿野鄉,鹿野村,210,41,234,87,-24,-46,-10.256,-52.874
10014050007,臺東縣,鹿野鄉,龍田村,176,55,168,199,8,-144,4.762,-72.362
10014050004,臺東縣,鹿野鄉,永安村,238,62,269,158,-31,-96,-11.524,-60.759
10014050005,臺東縣,鹿野鄉,瑞隆村,142,22,144,72,-2,-50,-1.389,-69.444
10014050003,臺東縣,鹿野鄉,瑞源村,153,41,131,89,22,-48,16.794,-53.933
10014050001,臺東縣,鹿野鄉,瑞和村,94,17,92,57,2,-40,2.174,-70.175
10014050002,臺東縣,鹿野鄉,瑞豐村,120,48,134,184,-14,-136,-10.448,-73.913
10014060005,臺東縣,池上鄉,福原村,377,83,386,274,-9,-191,-2.332,-69.708
10014060001,臺東縣,池上鄉,福文村,177,42,166,133,11,-91,6.627,-68.421
10014060002,臺東縣,池上鄉,慶豐村,100,25,133,81,-33,-56,-24.812,-69.136
10014060003,臺東縣,池上鄉,大坡村,50,9,53,20,-3,-11,-5.66,-55.0
10014060004,臺東縣,池上鄉,大埔村,134,38,163,87,-29,-49,-17.791,-56.322
10014060007,臺東縣,池上鄉,新興村,164,37,141,113,23,-76,16.312,-67.257
10014060006,臺東縣,池上鄉,錦園村,40,12,40,53,0,-41,0.0,-77.358
10014060008,臺東縣,池上鄉,萬安村,43,17,53,56,-10,-39,-18.868,-69.643
10014060009,臺東縣,池上鄉,富興村,76,7,86,41,-10,-34,-11.628,-82.927
10014060010,臺東縣,池上鄉,振興村,48,19,47,31,1,-12,2.128,-38.71
10014070007,臺東縣,東河鄉,都蘭村,423,88,427,243,-4,-155,-0.937,-63.786
10014070006,臺東縣,東河鄉,興昌村,188,53,177,116,11,-63,6.215,-54.31
10014070005,臺東縣,東河鄉,隆昌村,130,16,114,49,16,-33,14.035,-67.347
10014070003,臺東縣,東河鄉,東河村,214,22,191,72,23,-50,12.042,-69.444
10014070002,臺東縣,東河鄉,泰源村,157,32,179,65,-22,-33,-12.291,-50.769
10014070001,臺東縣,東河鄉,北源村,235,44,259,81,-24,-37,-9.266,-45.679
10014070004,臺東縣,東河鄉,尚德村,27,15,55,27,-28,-12,-50.909,-44.444
10014080006,臺東縣,長濱鄉,寧埔村,257,48,271,75,-14,-27,-5.166,-36.0
10014080005,臺東縣,長濱鄉,竹湖村,145,39,164,94,-19,-55,-11.585,-58.511
10014080004,臺東縣,長濱鄉,長濱村,390,64,402,185,-12,-121,-2.985,-65.405
10014080003,臺東縣,長濱鄉,忠勇村,94,26,81,43,13,-17,16.049,-39.535
10014080002,臺東縣,長濱鄉,三間村,248,23,267,65,-19,-42,-7.116,-64.615
10014080001,臺東縣,長濱鄉,樟原村,168,25,143,47,25,-22,17.483,-46.809
10014090001,臺東縣,太麻里鄉,美和村,193,62,163,214,30,-152,18.405,-71.028
10014090002,臺東縣,太麻里鄉,三和村,103,22,103,90,0,-68,0.0,-75.556
10014090003,臺東縣,太麻里鄉,華源村,81,39,84,103,-3,-64,-3.571,-62.136
10014090004,臺東縣,太麻里鄉,北里村,116,20,96,91,20,-71,20.833,-78.022
10014090006,臺東縣,太麻里鄉,大王村,350,51,382,193,-32,-142,-8.377,-73.575
10014090005,臺東縣,太麻里鄉,泰和村,289,52,281,166,8,-114,2.847,-68.675
10014090007,臺東縣,太麻里鄉,香蘭村,167,34,169,91,-2,-57,-1.183,-62.637
10014090008,臺東縣,太麻里鄉,金崙村,336,44,360,63,-24,-19,-6.667,-30.159
10014090009,臺東縣,太麻里鄉,多良村,173,23,231,40,-58,-17,-25.108,-42.5
10014100005,臺東縣,大武鄉,南興村,135,15,131,39,4,-24,3.053,-61.538
10014100004,臺東縣,大武鄉,尚武村,191,48,172,160,19,-112,11.047,-70.0
10014100003,臺東縣,大武鄉,大武村,223,52,247,97,-24,-45,-9.717,-46.392
10014100002,臺東縣,大武鄉,大鳥村,272,38,268,20,4,18,1.493,90.0
10014100001,臺東縣,大武鄉,大竹村,192,18,174,33,18,-15,10.345,-45.455
10014110003,臺東縣,綠島鄉,南寮村,242,51,194,63,48,-12,24.742,-19.048
10014110002,臺東縣,綠島鄉,中寮村,138,16,128,41,10,-25,7.812,-60.976
10014110001,臺東縣,綠島鄉,公舘村,142,10,155,43,-13,-33,-8.387,-76.744
10014120006,臺東縣,海端鄉,加拿村,105,11,122,21,-17,-10,-13.934,-47.619
10014120005,臺東縣,海端鄉,崁頂村,178,16,133,30,45,-14,33.835,-46.667
10014120004,臺東縣,海端鄉,海端村,195,13,187,36,8,-23,4.278,-63.889
10014120001,臺東縣,海端鄉,廣原村,165,13,169,25,-4,-12,-2.367,-48.0
10014120002,臺東縣,海端鄉,霧鹿村,61,6,83,20,-22,-14,-26.506,-70.0
10014120003,臺東縣,海端鄉,利稻村,36,1,38,29,-2,-28,-5.263,-96.552
10014130005,臺東縣,延平鄉,桃源村,219,34,199,94,20,-60,10.05,-63.83
10014130003,臺東縣,延平鄉,紅葉村,117,16,114,21,3,-5,2.632,-23.81
10014130002,臺東縣,延平鄉,永康村,96,3,102,10,-6,-7,-5.882,-70.0
10014130001,臺東縣,延平鄉,武陵村,116,13,159,22,-43,-9,-27.044,-40.909
10014130004,臺東縣,延平鄉,鸞山村,106,8,128,17,-22,-9,-17.188,-52.941
10014140003,臺東縣,金峰鄉,嘉蘭村,254,31,322,55,-68,-24,-21.118,-43.636
10014140002,臺東縣,金峰鄉,正興村,210,12,225,28,-15,-16,-6.667,-57.143
10014140001,臺東縣,金峰鄉,新興村,191,19,211,33,-20,-14,-9.479,-42.424
10014140004,臺東縣,金峰鄉,賓茂村,88,6,112,10,-24,-4,-21.429,-40.0
10014140005,臺東縣,金峰鄉,歷坵村,98,6,108,13,-10,-7,-9.259,-53.846
10014150004,臺東縣,達仁鄉,安朔村,160,19,163,44,-3,-25,-1.84,-56.818
10014150006,臺東縣,達仁鄉,南田村,84,11,91,16,-7,-5,-7.692,-31.25
10014150005,臺東縣,達仁鄉,森永村,100,6,115,28,-15,-22,-13.043,-78.571
10014150003,臺東縣,達仁鄉,新化村,117,9,83,15,34,-6,40.964,-40.0
10014150001,臺東縣,達仁鄉,台坂村,170,15,196,35,-26,-20,-13.265,-57.143
10014150002,臺東縣,達仁鄉,土坂村,216,25,234,41,-18,-16,-7.692,-39.024
10014160004,臺東縣,蘭嶼鄉,椰油村,117,34,133,53,-16,-19,-12.03,-35.849
10014160003,臺東縣,蘭嶼鄉,紅頭村,123,53,157,110,-34,-57,-21.656,-51.818
10014160001,臺東縣,蘭嶼鄉,東清村,76,42,116,92,-40,-50,-34.483,-54.348
10014160002,臺東縣,蘭嶼鄉,朗島村,28,52,38,90,-10,-38,-26.316,-42.222
67000050001,臺南市,後壁區,後壁里,303,132,258,432,45,-300,17.442,-69.444
67000050002,臺南市,後壁區,侯伯里,182,123,143,361,39,-238,27.273,-65.928
67000050003,臺南市,後壁區,嘉苳里,188,92,147,332,41,-240,27.891,-72.289
67000050004,臺南市,後壁區,土溝里,144,116,128,398,16,-282,12.5,-70.854
67000050023,臺南市,後壁區,上茄苳里,241,165,227,634,14,-469,6.167,-73.975
67000050024,臺南市,後壁區,菁豐里,210,69,150,300,60,-231,40.0,-77.0
67000050018,臺南市,後壁區,菁寮里,192,105,169,395,23,-290,13.609,-73.418
67000050019,臺南市,後壁區,新嘉里,113,77,80,222,33,-145,41.25,-65.315
67000050022,臺南市,後壁區,長短樹里,286,155,250,565,36,-410,14.4,-72.566
67000050010,臺南市,後壁區,竹新里,160,141,113,462,47,-321,41.593,-69.481
67000050011,臺南市,後壁區,新東里,260,144,188,416,72,-272,38.298,-65.385
67000050012,臺南市,後壁區,頂安里,228,103,179,304,49,-201,27.374,-66.118
67000050013,臺南市,後壁區,長安里,214,84,188,319,26,-235,13.83,-73.668
67000050014,臺南市,後壁區,福安里,283,158,226,457,57,-299,25.221,-65.427
67000030001,臺南市,白河區,白河里,223,120,210,462,13,-342,6.19,-74.026
67000030002,臺南市,白河區,永安里,475,268,411,864,64,-596,15.572,-68.981
67000030003,臺南市,白河區,外角里,170,129,187,359,-17,-230,-9.091,-64.067
67000030004,臺南市,白河區,庄內里,243,153,201,439,42,-286,20.896,-65.148
67000030005,臺南市,白河區,秀祐里,147,59,107,231,40,-172,37.383,-74.459
67000030006,臺南市,白河區,河東里,188,129,179,365,9,-236,5.028,-64.658
67000030007,臺南市,白河區,虎山里,60,34,58,115,2,-81,3.448,-70.435
67000030008,臺南市,白河區,大林里,42,48,43,138,-1,-90,-2.326,-65.217
67000030009,臺南市,白河區,崁頭里,43,16,39,82,4,-66,10.256,-80.488
67000030010,臺南市,白河區,六溪里,39,29,35,124,4,-95,11.429,-76.613
67000030012,臺南市,白河區,關嶺里,125,70,81,252,44,-182,54.321,-72.222
67000030011,臺南市,白河區,仙草里,139,59,138,243,1,-184,0.725,-75.72
67000030025,臺南市,白河區,詔豐里,239,194,198,545,41,-351,20.707,-64.404
67000030014,臺南市,白河區,大竹里,166,82,150,339,16,-257,10.667,-75.811
67000030026,臺南市,白河區,廣蓮里,186,141,155,426,31,-285,20.0,-66.901
67000030018,臺南市,白河區,竹門里,139,41,107,211,32,-170,29.907,-80.569
67000030019,臺南市,白河區,崎內里,89,30,87,104,2,-74,2.299,-71.154
67000030020,臺南市,白河區,昇安里,187,121,134,343,53,-222,39.552,-64.723
67000030021,臺南市,白河區,汴頭里,62,60,69,214,-7,-154,-10.145,-71.963
67000030022,臺南市,白河區,內角里,108,43,72,181,36,-138,50.0,-76.243
67000030027,臺南市,白河區,馬稠後里,135,66,122,322,13,-256,10.656,-79.503
67000170013,臺南市,北門區,永隆里,95,51,104,176,-9,-125,-8.654,-71.023
67000170005,臺南市,北門區,北門里,115,49,105,165,10,-116,9.524,-70.303
67000170009,臺南市,北門區,玉港里,83,29,62,181,21,-152,33.871,-83.978
67000170001,臺南市,北門區,保吉里,176,45,137,246,39,-201,28.467,-81.707
67000170014,臺南市,北門區,蚵寮里,146,51,132,297,14,-246,10.606,-82.828
67000170002,臺南市,北門區,雙春里,61,23,46,100,15,-77,32.609,-77.0
67000170006,臺南市,北門區,錦湖里,99,33,87,161,12,-128,13.793,-79.503
67000170011,臺南市,北門區,慈安里,75,31,63,137,12,-106,19.048,-77.372
67000170007,臺南市,北門區,三光里,156,46,142,255,14,-209,9.859,-81.961
67000170015,臺南市,北門區,文山里,132,81,112,321,20,-240,17.857,-74.766
67000130006,臺南市,學甲區,秀昌里,352,196,272,683,80,-487,29.412,-71.303
67000130007,臺南市,學甲區,明宜里,242,185,184,594,58,-409,31.522,-68.855
67000130005,臺南市,學甲區,慈福里,371,146,258,518,113,-372,43.798,-71.815
67000130001,臺南市,學甲區,仁得里,583,340,466,1115,117,-775,25.107,-69.507
67000130010,臺南市,學甲區,新達里,307,137,258,526,49,-389,18.992,-73.954
67000130002,臺南市,學甲區,新榮里,378,201,240,646,138,-445,57.5,-68.885
67000130011,臺南市,學甲區,大灣里,129,57,104,274,25,-217,24.038,-79.197
67000130008,臺南市,學甲區,豐和里,137,99,98,349,39,-250,39.796,-71.633
67000130013,臺南市,學甲區,中洲里,193,88,147,320,46,-232,31.293,-72.5
67000130003,臺南市,學甲區,光華里,145,104,105,351,40,-247,38.095,-70.37
67000130004,臺南市,學甲區,宅港里,96,58,89,197,7,-139,7.865,-70.558
67000130009,臺南市,學甲區,平和里,84,91,61,312,23,-221,37.705,-70.833
67000130012,臺南市,學甲區,三慶里,150,103,141,335,9,-232,6.383,-69.254
67000020001,臺南市,鹽水區,水秀里,241,114,193,399,48,-285,24.87,-71.429
67000020026,臺南市,鹽水區,津城里,252,130,200,408,52,-278,26.0,-68.137
67000020027,臺南市,鹽水區,月港里,292,123,279,374,13,-251,4.659,-67.112
67000020008,臺南市,鹽水區,橋南里,518,236,448,846,70,-610,15.625,-72.104
67000020011,臺南市,鹽水區,岸內里,630,268,510,935,120,-667,23.529,-71.337
67000020010,臺南市,鹽水區,汫水里,64,78,41,272,23,-194,56.098,-71.324
67000020029,臺南市,鹽水區,義中里,242,119,141,421,101,-302,71.631,-71.734
67000020028,臺南市,鹽水區,三明里,179,122,138,485,41,-363,29.71,-74.845
67000020030,臺南市,鹽水區,文昌里,110,70,93,274,17,-204,18.28,-74.453
67000020014,臺南市,鹽水區,歡雅里,213,107,173,434,40,-327,23.121,-75.346
67000020032,臺南市,鹽水區,三和里,100,70,107,263,-7,-193,-6.542,-73.384
67000020031,臺南市,鹽水區,竹林里,118,71,113,325,5,-254,4.425,-78.154
67000020033,臺南市,鹽水區,坔頭港里,184,84,133,336,51,-252,38.346,-75.0
67000010001,臺南市,新營區,忠政里,980,349,998,945,-18,-596,-1.804,-63.069
67000010002,臺南市,新營區,民權里,419,191,394,518,25,-327,6.345,-63.127
67000010003,臺南市,新營區,三仙里,428,225,469,677,-41,-452,-8.742,-66.765
67000010030,臺南市,新營區,永平里,438,209,446,685,-8,-476,-1.794,-69.489
67000010007,臺南市,新營區,大宏里,510,228,469,696,41,-468,8.742,-67.241
67000010008,臺南市,新營區,王公里,783,281,697,876,86,-595,12.339,-67.922
67000010029,臺南市,新營區,新東里,1440,404,1187,1313,253,-909,21.314,-69.231
67000010009,臺南市,新營區,中營里,233,68,188,280,45,-212,23.936,-75.714
67000010010,臺南市,新營區,土庫里,207,111,172,399,35,-288,20.349,-72.18
67000010013,臺南市,新營區,興業里,382,126,336,400,46,-274,13.69,-68.5
67000010012,臺南市,新營區,南興里,406,139,390,497,16,-358,4.103,-72.032
67000010014,臺南市,新營區,民生里,540,228,459,743,81,-515,17.647,-69.314
67000010027,臺南市,新營區,新北里,1010,345,840,1045,170,-700,20.238,-66.986
67000010028,臺南市,新營區,新南里,1067,402,854,1191,213,-789,24.941,-66.247
67000010015,臺南市,新營區,民榮里,799,317,639,1001,160,-684,25.039,-68.332
67000010016,臺南市,新營區,埤寮里,270,127,228,414,42,-287,18.421,-69.324
67000010017,臺南市,新營區,護鎮里,212,123,169,343,43,-220,25.444,-64.14
67000010018,臺南市,新營區,太南里,225,98,151,448,74,-350,49.007,-78.125
67000010019,臺南市,新營區,太北里,256,115,195,462,61,-347,31.282,-75.108
67000010020,臺南市,新營區,南紙里,747,263,544,778,203,-515,37.316,-66.195
67000010021,臺南市,新營區,嘉芳里,287,134,214,446,73,-312,34.112,-69.955
67000010026,臺南市,新營區,姑爺里,130,43,100,241,30,-198,30.0,-82.158
67000010025,臺南市,新營區,五興里,219,119,151,459,68,-340,45.033,-74.074
67000040001,臺南市,柳營區,士林里,313,171,263,449,50,-278,19.011,-61.915
67000040002,臺南市,柳營區,光福里,286,127,262,442,24,-315,9.16,-71.267
67000040003,臺南市,柳營區,中埕里,202,96,163,288,39,-192,23.926,-66.667
67000040004,臺南市,柳營區,東昇里,528,255,388,704,140,-449,36.082,-63.778
67000040005,臺南市,柳營區,八翁里,260,66,168,340,92,-274,54.762,-80.588
67000040006,臺南市,柳營區,人和里,142,55,107,189,35,-134,32.71,-70.899
67000040007,臺南市,柳營區,太康里,256,120,201,403,55,-283,27.363,-70.223
67000040008,臺南市,柳營區,重溪里,254,138,173,474,81,-336,46.821,-70.886
67000040009,臺南市,柳營區,篤農里,150,95,136,333,14,-238,10.294,-71.471
67000040010,臺南市,柳營區,大農里,65,52,54,200,11,-148,20.37,-74.0
67000040011,臺南市,柳營區,神農里,189,104,127,351,62,-247,48.819,-70.37
67000040012,臺南市,柳營區,果毅里,166,73,121,315,45,-242,37.19,-76.825
67000040013,臺南市,柳營區,旭山里,210,76,158,348,52,-272,32.911,-78.161
67000060001,臺南市,東山區,東山里,232,110,195,281,37,-171,18.974,-60.854
67000060002,臺南市,東山區,東中里,335,163,326,544,9,-381,2.761,-70.037
67000060003,臺南市,東山區,東正里,136,106,130,340,6,-234,4.615,-68.824
67000060005,臺南市,東山區,大客里,106,50,98,197,8,-147,8.163,-74.619
67000060004,臺南市,東山區,三榮里,94,35,84,201,10,-166,11.905,-82.587
67000060006,臺南市,東山區,科里里,146,80,130,289,16,-209,12.308,-72.318
67000060007,臺南市,東山區,東河里,91,66,75,217,16,-151,21.333,-69.585
67000060016,臺南市,東山區,聖賢里,267,114,211,511,56,-397,26.54,-77.691
67000060008,臺南市,東山區,南溪里,45,13,31,86,14,-73,45.161,-84.884
67000060009,臺南市,東山區,水雲里,31,20,30,76,1,-56,3.333,-73.684
67000060010,臺南市,東山區,林安里,44,23,42,94,2,-71,4.762,-75.532
67000060011,臺南市,東山區,東原里,196,64,230,389,-34,-325,-14.783,-83.548
67000060012,臺南市,東山區,嶺南里,51,13,53,94,-2,-81,-3.774,-86.17
67000060013,臺南市,東山區,南勢里,71,30,83,195,-12,-165,-14.458,-84.615
67000060014,臺南市,東山區,青山里,103,33,109,190,-6,-157,-5.505,-82.632
67000060015,臺南市,東山區,高原里,100,28,108,111,-8,-83,-7.407,-74.775
67000160001,臺南市,將軍區,長榮里,157,66,119,317,38,-251,31.933,-79.18
67000160020,臺南市,將軍區,西甲里,381,160,256,658,125,-498,48.828,-75.684
67000160021,臺南市,將軍區,忠嘉里,365,179,245,603,120,-424,48.98,-70.315
67000160022,臺南市,將軍區,苓仔寮里,259,174,196,563,63,-389,32.143,-69.094
67000160019,臺南市,將軍區,巷埔里,124,82,90,379,34,-297,37.778,-78.364
67000160023,臺南市,將軍區,將軍里,192,96,151,396,41,-300,27.152,-75.758
67000160013,臺南市,將軍區,玉山里,74,73,48,211,26,-138,54.167,-65.403
67000160014,臺南市,將軍區,廣山里,53,36,62,120,-9,-84,-14.516,-70.0
67000160015,臺南市,將軍區,長沙里,125,87,100,347,25,-260,25.0,-74.928
67000160016,臺南市,將軍區,平沙里,98,76,81,343,17,-267,20.988,-77.843
67000160017,臺南市,將軍區,鯤鯓里,175,141,128,526,47,-385,36.719,-73.194
67000160018,臺南市,將軍區,鯤溟里,79,44,57,218,22,-174,38.596,-79.817
67000080001,臺南市,下營區,下營里,234,116,240,377,-6,-261,-2.5,-69.231
67000080002,臺南市,下營區,仁里里,290,153,219,482,71,-329,32.42,-68.257
67000080003,臺南市,下營區,宅內里,294,108,224,382,70,-274,31.25,-71.728
67000080004,臺南市,下營區,後街里,252,104,228,381,24,-277,10.526,-72.703
67000080005,臺南市,下營區,新興里,349,144,237,444,112,-300,47.257,-67.568
67000080006,臺南市,下營區,營前里,332,149,266,541,66,-392,24.812,-72.458
67000080017,臺南市,下營區,大吉里,203,99,205,361,-2,-262,-0.976,-72.576
67000080016,臺南市,下營區,茅營里,309,202,224,627,85,-425,37.946,-67.783
67000080011,臺南市,下營區,開化里,241,153,197,532,44,-379,22.335,-71.241
67000080012,臺南市,下營區,西連里,125,75,90,302,35,-227,38.889,-75.166
67000080013,臺南市,下營區,賀建里,142,86,129,295,13,-209,10.078,-70.847
67000080018,臺南市,下營區,紅甲里,288,146,197,658,91,-512,46.193,-77.812
67000090001,臺南市,六甲區,六甲里,425,225,324,735,101,-510,31.173,-69.388
67000090002,臺南市,六甲區,甲東里,354,206,279,680,75,-474,26.882,-69.706
67000090003,臺南市,六甲區,甲南里,192,138,182,360,10,-222,5.495,-61.667
67000090005,臺南市,六甲區,七甲里,282,145,194,498,88,-353,45.361,-70.884
67000090006,臺南市,六甲區,二甲里,535,267,390,867,145,-600,37.179,-69.204
67000090007,臺南市,六甲區,水林里,268,146,211,560,57,-414,27.014,-73.929
67000090008,臺南市,六甲區,中社里,268,124,209,404,59,-280,28.23,-69.307
67000090009,臺南市,六甲區,龜港里,253,143,158,319,95,-176,60.127,-55.172
67000090010,臺南市,六甲區,菁埔里,104,49,95,170,9,-121,9.474,-71.176
67000090011,臺南市,六甲區,王爺里,47,23,53,143,-6,-120,-11.321,-83.916
67000090012,臺南市,六甲區,大丘里,38,15,55,129,-17,-114,-30.909,-88.372
67000150001,臺南市,七股區,後港里,120,78,93,297,27,-219,29.032,-73.737
67000150002,臺南市,七股區,大潭里,72,77,48,184,24,-107,50.0,-58.152
67000150004,臺南市,七股區,篤加里,105,86,98,209,7,-123,7.143,-58.852
67000150005,臺南市,七股區,頂山里,90,41,95,210,-5,-169,-5.263,-80.476
67000150006,臺南市,七股區,西寮里,48,36,41,120,7,-84,17.073,-70.0
67000150007,臺南市,七股區,塩埕里,32,53,31,123,1,-70,3.226,-56.911
67000150017,臺南市,七股區,中寮里,74,53,60,176,14,-123,23.333,-69.886
67000150008,臺南市,七股區,龍山里,137,154,111,497,26,-343,23.423,-69.014
67000150009,臺南市,七股區,溪南里,66,18,45,83,21,-65,46.667,-78.313
67000150010,臺南市,七股區,七股里,96,67,77,269,19,-202,24.675,-75.093
67000150011,臺南市,七股區,玉成里,101,49,76,200,25,-151,32.895,-75.5
67000150012,臺南市,七股區,大埕里,353,195,216,665,137,-470,63.426,-70.677
67000150015,臺南市,七股區,樹林里,238,138,138,488,100,-350,72.464,-71.721
67000150018,臺南市,七股區,竹橋里,154,94,129,353,25,-259,19.38,-73.371
67000150019,臺南市,七股區,義合里,241,117,196,513,45,-396,22.959,-77.193
67000150021,臺南市,七股區,永吉里,159,58,124,223,35,-165,28.226,-73.991
67000150022,臺南市,七股區,三股里,148,73,116,327,32,-254,27.586,-77.676
67000150023,臺南市,七股區,十份里,167,46,140,289,27,-243,19.286,-84.083
67000120001,臺南市,佳里區,東寧里,391,235,337,664,54,-429,16.024,-64.608
67000120002,臺南市,佳里區,忠仁里,376,244,309,771,67,-527,21.683,-68.353
67000120003,臺南市,佳里區,鎮山里,935,452,668,1488,267,-1036,39.97,-69.624
67000120005,臺南市,佳里區,安西里,989,457,745,1529,244,-1072,32.752,-70.111
67000120023,臺南市,佳里區,文新里,909,411,751,1274,158,-863,21.039,-67.739
67000120004,臺南市,佳里區,建南里,722,321,535,1067,187,-746,34.953,-69.916
67000120027,臺南市,佳里區,南勢里,799,393,528,1165,271,-772,51.326,-66.266
67000120006,臺南市,佳里區,六安里,734,303,582,992,152,-689,26.117,-69.456
67000120007,臺南市,佳里區,佳化里,294,152,239,576,55,-424,23.013,-73.611
67000120024,臺南市,佳里區,佳興里,297,212,239,658,58,-446,24.268,-67.781
67000120022,臺南市,佳里區,營溪里,150,80,127,274,23,-194,18.11,-70.803
67000120012,臺南市,佳里區,海澄里,312,165,238,531,74,-366,31.092,-68.927
67000120025,臺南市,佳里區,下營里,291,168,211,512,80,-344,37.915,-67.188
67000120026,臺南市,佳里區,塭內里,352,253,241,818,111,-565,46.058,-69.071
67000120019,臺南市,佳里區,民安里,279,142,154,509,125,-367,81.169,-72.102
67000120020,臺南市,佳里區,子龍里,378,250,248,741,130,-491,52.419,-66.262
67000070030,臺南市,麻豆區,新興里,295,218,191,604,104,-386,54.45,-63.907
67000070005,臺南市,麻豆區,巷口里,373,274,321,649,52,-375,16.199,-57.781
67000070003,臺南市,麻豆區,東角里,446,279,372,749,74,-470,19.892,-62.75
67000070004,臺南市,麻豆區,晋江里,351,285,297,804,54,-519,18.182,-64.552
67000070006,臺南市,麻豆區,中興里,310,176,263,588,47,-412,17.871,-70.068
67000070007,臺南市,麻豆區,興農里,225,217,171,476,54,-259,31.579,-54.412
67000070009,臺南市,麻豆區,油車里,508,435,400,1193,108,-758,27.0,-63.537
67000070010,臺南市,麻豆區,北勢里,86,86,78,380,8,-294,10.256,-77.368
67000070011,臺南市,麻豆區,大埕里,449,306,336,914,113,-608,33.631,-66.521
67000070033,臺南市,麻豆區,清水里,209,151,170,451,39,-300,22.941,-66.519
67000070014,臺南市,麻豆區,南勢里,428,218,332,657,96,-439,28.916,-66.819
67000070015,臺南市,麻豆區,寮廍里,209,195,152,595,57,-400,37.5,-67.227
67000070017,臺南市,麻豆區,埤頭里,242,248,180,767,62,-519,34.444,-67.666
67000070019,臺南市,麻豆區,海埔里,265,177,188,644,77,-467,40.957,-72.516
67000070021,臺南市,麻豆區,港尾里,210,113,125,390,85,-277,68.0,-71.026
67000070022,臺南市,麻豆區,麻口里,159,98,88,358,71,-260,80.682,-72.626
67000070024,臺南市,麻豆區,安業里,123,163,128,499,-5,-336,-3.906,-67.335
67000070031,臺南市,麻豆區,謝厝寮里,202,208,149,624,53,-416,35.57,-66.667
67000070028,臺南市,麻豆區,安正里,107,49,88,288,19,-239,21.591,-82.986
67000070032,臺南市,麻豆區,井東里,205,192,162,594,43,-402,26.543,-67.677
67000100001,臺南市,官田區,官田里,332,165,255,554,77,-389,30.196,-70.217
67000100002,臺南市,官田區,二鎮里,476,346,292,1020,184,-674,63.014,-66.078
67000100014,臺南市,官田區,烏山頭里,166,128,125,396,41,-268,32.8,-67.677
67000100005,臺南市,官田區,大崎里,46,34,48,96,-2,-62,-4.167,-64.583
67000100006,臺南市,官田區,隆田里,303,190,290,493,13,-303,4.483,-61.46
67000100007,臺南市,官田區,隆本里,669,254,544,866,125,-612,22.978,-70.67
67000100008,臺南市,官田區,南廍里,162,85,125,332,37,-247,29.6,-74.398
67000100016,臺南市,官田區,東西庄里,140,262,91,712,49,-450,53.846,-63.202
67000100015,臺南市,官田區,渡拔里,400,260,311,763,89,-503,28.617,-65.924
67000100013,臺南市,官田區,社子里,97,68,67,246,30,-178,44.776,-72.358
67000190001,臺南市,善化區,東關里,186,84,171,265,15,-181,8.772,-68.302
67000190002,臺南市,善化區,坐駕里,744,316,638,922,106,-606,16.614,-65.727
67000190003,臺南市,善化區,光文里,1074,526,851,1356,223,-830,26.204,-61.209
67000190004,臺南市,善化區,文昌里,470,228,354,663,116,-435,32.768,-65.611
67000190005,臺南市,善化區,南關里,256,142,225,508,31,-366,13.778,-72.047
67000190022,臺南市,善化區,頂街里,244,113,186,298,58,-185,31.183,-62.081
67000190008,臺南市,善化區,文正里,245,140,200,429,45,-289,22.5,-67.366
67000190009,臺南市,善化區,胡家里,128,182,105,425,23,-243,21.905,-57.176
67000190010,臺南市,善化區,胡厝里,318,203,244,594,74,-391,30.328,-65.825
67000190011,臺南市,善化區,什乃里,193,143,145,348,48,-205,33.103,-58.908
67000190012,臺南市,善化區,溪美里,370,199,278,561,92,-362,33.094,-64.528
67000190013,臺南市,善化區,六分里,92,78,64,219,28,-141,43.75,-64.384
67000190014,臺南市,善化區,六德里,160,103,90,302,70,-199,77.778,-65.894
67000190015,臺南市,善化區,田寮里,215,173,192,482,23,-309,11.979,-64.108
67000190023,臺南市,善化區,昌隆里,334,220,210,571,124,-351,59.048,-61.471
67000190018,臺南市,善化區,牛庄里,284,174,220,459,64,-285,29.091,-62.092
67000190019,臺南市,善化區,嘉北里,262,183,185,451,77,-268,41.622,-59.424
67000190020,臺南市,善化區,嘉南里,174,133,107,320,67,-187,62.617,-58.438
67000190021,臺南市,善化區,小新里,903,416,590,1092,313,-676,53.051,-61.905
67000190024,臺南市,善化區,蓮潭里,915,396,498,873,417,-477,83.735,-54.639
67000110001,臺南市,大內區,石湖里,123,79,121,264,2,-185,1.653,-70.076
67000110002,臺南市,大內區,石林里,72,62,54,179,18,-117,33.333,-65.363
67000110003,臺南市,大內區,石城里,154,99,124,398,30,-299,24.194,-75.126
67000110004,臺南市,大內區,內江里,133,42,124,202,9,-160,7.258,-79.208
67000110005,臺南市,大內區,大內里,129,74,113,236,16,-162,14.159,-68.644
67000110006,臺南市,大內區,內郭里,65,57,70,179,-5,-122,-7.143,-68.156
67000110007,臺南市,大內區,頭社里,108,71,100,237,8,-166,8.0,-70.042
67000110008,臺南市,大內區,環湖里,97,38,69,166,28,-128,40.58,-77.108
67000110009,臺南市,大內區,二溪里,112,46,118,211,-6,-165,-5.085,-78.199
67000110010,臺南市,大內區,曲溪里,66,43,47,173,19,-130,40.426,-75.145
67000230001,臺南市,玉井區,玉井里,231,68,235,212,-4,-144,-1.702,-67.925
67000230002,臺南市,玉井區,玉田里,677,165,661,605,16,-440,2.421,-72.727
67000230003,臺南市,玉井區,中正里,203,75,207,278,-4,-203,-1.932,-73.022
67000230004,臺南市,玉井區,竹圍里,221,96,214,264,7,-168,3.271,-63.636
67000230005,臺南市,玉井區,沙田里,108,18,92,104,16,-86,17.391,-82.692
67000230006,臺南市,玉井區,三埔里,58,23,60,116,-2,-93,-3.333,-80.172
67000230007,臺南市,玉井區,三和里,117,51,115,175,2,-124,1.739,-70.857
67000230008,臺南市,玉井區,望明里,231,89,222,275,9,-186,4.054,-67.636
67000230009,臺南市,玉井區,層林里,94,23,76,129,18,-106,23.684,-82.171
67000230010,臺南市,玉井區,豐里里,145,56,141,173,4,-117,2.837,-67.63
67000240001,臺南市,楠西區,楠西里,343,73,324,259,19,-186,5.864,-71.815
67000240002,臺南市,楠西區,灣丘里,158,45,130,162,28,-117,21.538,-72.222
67000240003,臺南市,楠西區,密枝里,92,26,106,96,-14,-70,-13.208,-72.917
67000240004,臺南市,楠西區,照興里,152,30,128,177,24,-147,18.75,-83.051
67000240005,臺南市,楠西區,鹿田里,169,38,183,132,-14,-94,-7.65,-71.212
67000240006,臺南市,楠西區,龜丹里,112,31,94,111,18,-80,19.149,-72.072
67000240007,臺南市,楠西區,東勢里,397,92,358,369,39,-277,10.894,-75.068
67000140001,臺南市,西港區,西港里,445,263,350,886,95,-623,27.143,-70.316
67000140012,臺南市,西港區,慶安里,659,351,478,1090,181,-739,37.866,-67.798
67000140002,臺南市,西港區,南海里,402,249,241,742,161,-493,66.805,-66.442
67000140003,臺南市,西港區,港東里,242,113,144,457,98,-344,68.056,-75.274
67000140005,臺南市,西港區,後營里,184,140,108,390,76,-250,70.37,-64.103
67000140006,臺南市,西港區,營西里,184,121,120,353,64,-232,53.333,-65.722
67000140007,臺南市,西港區,金砂里,99,40,78,237,21,-197,26.923,-83.122
67000140008,臺南市,西港區,劉厝里,216,143,131,363,85,-220,64.885,-60.606
67000140009,臺南市,西港區,竹林里,188,139,124,432,64,-293,51.613,-67.824
67000140010,臺南市,西港區,永樂里,189,127,134,405,55,-278,41.045,-68.642
67000140011,臺南市,西港區,新復里,145,80,101,178,44,-98,43.564,-55.056
67000210001,臺南市,安定區,蘇林里,355,229,245,659,110,-430,44.898,-65.25
67000210002,臺南市,安定區,蘇厝里,325,160,250,526,75,-366,30.0,-69.582
67000210003,臺南市,安定區,安定里,247,119,167,400,80,-281,47.904,-70.25
67000210004,臺南市,安定區,安加里,330,186,276,616,54,-430,19.565,-69.805
67000210006,臺南市,安定區,港尾里,267,150,168,420,99,-270,58.929,-64.286
67000210007,臺南市,安定區,中榮里,328,163,222,496,106,-333,47.748,-67.137
67000210008,臺南市,安定區,港口里,514,260,382,808,132,-548,34.555,-67.822
67000210009,臺南市,安定區,港南里,498,262,318,774,180,-512,56.604,-66.15
67000210018,臺南市,安定區,嘉同里,384,165,266,656,118,-491,44.361,-74.848
67000210012,臺南市,安定區,中沙里,146,72,101,214,45,-142,44.554,-66.355
67000210013,臺南市,安定區,新吉里,401,273,278,697,123,-424,44.245,-60.832
67000210014,臺南市,安定區,海寮里,430,203,318,718,112,-515,35.22,-71.727
67000210017,臺南市,安定區,文科里,207,169,175,505,32,-336,18.286,-66.535
67000220001,臺南市,山上區,明和里,243,95,210,363,33,-268,15.714,-73.829
67000220002,臺南市,山上區,南洲里,212,122,214,428,-2,-306,-0.935,-71.495
67000220003,臺南市,山上區,山上里,194,71,128,212,66,-141,51.562,-66.509
67000220004,臺南市,山上區,新莊里,121,74,81,221,40,-147,49.383,-66.516
67000220005,臺南市,山上區,玉峯里,59,22,66,132,-7,-110,-10.606,-83.333
67000220006,臺南市,山上區,平陽里,66,14,69,68,-3,-54,-4.348,-79.412
67000220007,臺南市,山上區,豐德里,55,22,42,77,13,-55,30.952,-71.429
67000260001,臺南市,左鎮區,光和里,46,11,51,74,-5,-63,-9.804,-85.135
67000260002,臺南市,左鎮區,榮和里,62,47,72,156,-10,-109,-13.889,-69.872
67000260003,臺南市,左鎮區,左鎮里,57,23,51,106,6,-83,11.765,-78.302
67000260004,臺南市,左鎮區,中正里,87,36,111,123,-24,-87,-21.622,-70.732
67000260005,臺南市,左鎮區,睦光里,45,12,52,68,-7,-56,-13.462,-82.353
67000260006,臺南市,左鎮區,內庄里,59,24,62,85,-3,-61,-4.839,-71.765
67000260008,臺南市,左鎮區,岡林里,44,37,40,97,4,-60,10.0,-61.856
67000260009,臺南市,左鎮區,草山里,37,18,36,60,1,-42,2.778,-70.0
67000260010,臺南市,左鎮區,二寮里,15,17,17,71,-2,-54,-11.765,-76.056
67000260007,臺南市,左鎮區,澄山里,27,40,37,131,-10,-91,-27.027,-69.466
67000250001,臺南市,南化區,南化里,224,73,219,322,5,-249,2.283,-77.329
67000250002,臺南市,南化區,小崙里,105,31,91,125,14,-94,15.385,-75.2
67000250005,臺南市,南化區,東和里,69,19,77,100,-8,-81,-10.39,-81.0
67000250006,臺南市,南化區,西埔里,93,24,101,109,-8,-85,-7.921,-77.982
67000250003,臺南市,南化區,中坑里,67,14,57,60,10,-46,17.544,-76.667
67000250007,臺南市,南化區,北寮里,182,43,171,176,11,-133,6.433,-75.568
67000250008,臺南市,南化區,玉山里,148,48,148,161,0,-113,0.0,-70.186
67000250009,臺南市,南化區,關山里,74,9,106,77,-32,-68,-30.189,-88.312
67000250004,臺南市,南化區,北平里,71,24,77,123,-6,-99,-7.792,-80.488
67000350001,臺南市,安南區,東和里,597,263,385,751,212,-488,55.065,-64.98
67000350004,臺南市,安南區,州南里,990,481,647,1327,343,-846,53.014,-63.753
67000350005,臺南市,安南區,州北里,829,409,582,1230,247,-821,42.44,-66.748
67000350002,臺南市,安南區,安順里,942,406,665,1236,277,-830,41.654,-67.152
67000350010,臺南市,安南區,新順里,1210,583,850,1648,360,-1065,42.353,-64.624
67000350008,臺南市,安南區,頂安里,741,420,545,1326,196,-906,35.963,-68.326
67000350009,臺南市,安南區,安慶里,1022,608,765,1735,257,-1127,33.595,-64.957
67000350038,臺南市,安南區,溪北里,475,294,407,810,68,-516,16.708,-63.704
67000350037,臺南市,安南區,安和里,359,202,254,638,105,-436,41.339,-68.339
67000350007,臺南市,安南區,安西里,663,289,458,981,205,-692,44.76,-70.54
67000350039,臺南市,安南區,溪頂里,821,412,648,1231,173,-819,26.698,-66.531
67000350006,臺南市,安南區,安東里,486,287,370,814,116,-527,31.351,-64.742
67000350043,臺南市,安南區,鳳凰里,693,341,575,1081,118,-740,20.522,-68.455
67000350044,臺南市,安南區,梅花里,715,350,546,1070,169,-720,30.952,-67.29
67000350045,臺南市,安南區,理想里,728,433,552,1358,176,-925,31.884,-68.115
67000350015,臺南市,安南區,海東里,845,481,584,1418,261,-937,44.692,-66.079
67000350051,臺南市,安南區,大安里,648,361,456,997,192,-636,42.105,-63.791
67000350011,臺南市,安南區,原佃里,438,182,295,568,143,-386,48.475,-67.958
67000350013,臺南市,安南區,長安里,825,432,534,1305,291,-873,54.494,-66.897
67000350014,臺南市,安南區,公親里,165,101,127,332,38,-231,29.921,-69.578
67000350048,臺南市,安南區,布袋里,294,154,194,384,100,-230,51.546,-59.896
67000350012,臺南市,安南區,總頭里,303,177,205,536,98,-359,47.805,-66.978
67000350025,臺南市,安南區,南興里,310,131,158,487,152,-356,96.203,-73.101
67000350026,臺南市,安南區,學東里,461,181,232,564,229,-383,98.707,-67.908
67000350022,臺南市,安南區,佃東里,544,302,387,809,157,-507,40.568,-62.67
67000350023,臺南市,安南區,佃西里,325,135,219,498,106,-363,48.402,-72.892
67000350021,臺南市,安南區,淵西里,637,273,361,788,276,-515,76.454,-65.355
67000350016,臺南市,安南區,海西里,502,231,375,717,127,-486,33.867,-67.782
67000350018,臺南市,安南區,溪心里,1209,565,927,1746,282,-1181,30.421,-67.64
67000350020,臺南市,安南區,淵東里,785,401,520,1191,265,-790,50.962,-66.331
67000350047,臺南市,安南區,淵中里,519,252,386,873,133,-621,34.456,-71.134
67000350040,臺南市,安南區,溪墘里,460,287,366,874,94,-587,25.683,-67.162
67000350041,臺南市,安南區,海佃里,684,425,501,1301,183,-876,36.527,-67.333
67000350049,臺南市,安南區,國安里,864,434,363,779,501,-345,138.017,-44.288
67000350046,臺南市,安南區,溪東里,823,414,567,1056,256,-642,45.15,-60.795
67000350050,臺南市,安南區,安富里,795,436,617,1451,178,-1015,28.849,-69.952
67000350042,臺南市,安南區,幸福里,572,388,425,1130,147,-742,34.588,-65.664
67000350017,臺南市,安南區,海南里,606,301,311,691,295,-390,94.855,-56.44
67000350027,臺南市,安南區,城東里,264,80,186,338,78,-258,41.935,-76.331
67000350030,臺南市,安南區,城南里,510,238,337,798,173,-560,51.335,-70.175
67000350032,臺南市,安南區,青草里,183,70,126,326,57,-256,45.238,-78.528
67000350031,臺南市,安南區,城西里,144,73,131,373,13,-300,9.924,-80.429
67000350028,臺南市,安南區,城北里,232,122,161,428,71,-306,44.099,-71.495
67000350029,臺南市,安南區,城中里,183,72,144,259,39,-187,27.083,-72.201
67000350033,臺南市,安南區,砂崙里,192,78,142,366,50,-288,35.211,-78.689
67000350052,臺南市,安南區,媽祖宮里,231,78,,,,,,
67000350035,臺南市,安南區,鹿耳里,130,30,114,166,16,-136,14.035,-81.928
67000350036,臺南市,安南區,四草里,325,134,248,492,77,-358,31.048,-72.764
67000350019,臺南市,安南區,塩田里,297,115,274,375,23,-260,8.394,-69.333
67000340001,臺南市,北區,開元里,651,279,593,855,58,-576,9.781,-67.368
67000340038,臺南市,北區,元寶里,892,343,705,900,187,-557,26.525,-61.889
67000340045,臺南市,北區,合興里,654,328,622,913,32,-585,5.145,-64.074
67000340005,臺南市,北區,力行里,552,206,528,563,24,-357,4.545,-63.41
67000340019,臺南市,北區,重興里,514,213,425,454,89,-241,20.941,-53.084
67000340004,臺南市,北區,東興里,459,179,493,442,-34,-263,-6.897,-59.502
67000340044,臺南市,北區,長勝里,982,274,1048,655,-66,-381,-6.298,-58.168
67000340007,臺南市,北區,振興里,368,176,345,534,23,-358,6.667,-67.041
67000340008,臺南市,北區,仁愛里,523,226,477,610,46,-384,9.644,-62.951
67000340032,臺南市,北區,中樓里,251,124,276,379,-25,-255,-9.058,-67.282
67000340039,臺南市,北區,永祥里,631,257,578,779,53,-522,9.17,-67.009
67000340046,臺南市,北區,北門里,1047,446,969,1221,78,-775,8.05,-63.473
67000340048,臺南市,北區,大光里,1144,318,1203,833,-59,-515,-4.904,-61.825
67000340049,臺南市,北區,大興里,554,266,522,738,32,-472,6.13,-63.957
67000340033,臺南市,北區,公園里,349,137,385,427,-36,-290,-9.351,-67.916
67000340051,臺南市,北區,北華里,548,336,525,935,23,-599,4.381,-64.064
67000340050,臺南市,北區,長興里,428,212,415,713,13,-501,3.133,-70.266
67000340047,臺南市,北區,小北里,598,321,601,988,-3,-667,-0.499,-67.51
67000340023,臺南市,北區,正覺里,515,335,449,930,66,-595,14.699,-63.978
67000340024,臺南市,北區,成功里,805,399,675,1258,130,-859,19.259,-68.283
67000340052,臺南市,北區,華德里,770,305,565,1001,205,-696,36.283,-69.53
67000340053,臺南市,北區,福德里,1032,454,798,1161,234,-707,29.323,-60.896
67000340040,臺南市,北區,成德里,811,448,769,1130,42,-682,5.462,-60.354
67000340020,臺南市,北區,和順里,956,535,971,1235,-15,-700,-1.545,-56.68
67000340054,臺南市,北區,立人里,405,311,372,744,33,-433,8.871,-58.199
67000340055,臺南市,北區,雙安里,457,226,416,600,41,-374,9.856,-62.333
67000340041,臺南市,北區,文成里,563,277,489,837,74,-560,15.133,-66.906
67000340056,臺南市,北區,元美里,584,258,492,836,92,-578,18.699,-69.139
67000340025,臺南市,北區,文元里,623,318,523,916,100,-598,19.12,-65.284
67000340042,臺南市,北區,大和里,615,378,471,1077,144,-699,30.573,-64.903
67000340026,臺南市,北區,大港里,1017,492,882,1492,135,-1000,15.306,-67.024
67000340018,臺南市,北區,大豐里,646,406,531,1148,115,-742,21.657,-64.634
67000340043,臺南市,北區,賢北里,677,406,578,1069,99,-663,17.128,-62.021
67000200001,臺南市,新市區,新市里,471,223,399,744,72,-521,18.045,-70.027
67000200002,臺南市,新市區,新和里,1262,555,950,1703,312,-1148,32.842,-67.41
67000200003,臺南市,新市區,社內里,530,237,322,793,208,-556,64.596,-70.113
67000200004,臺南市,新市區,大洲里,134,63,87,225,47,-162,54.023,-72.0
67000200005,臺南市,新市區,豐華里,135,72,90,226,45,-154,50.0,-68.142
67000200006,臺南市,新市區,三舍里,294,141,178,430,116,-289,65.169,-67.209
67000200007,臺南市,新市區,大營里,717,297,472,781,245,-484,51.907,-61.972
67000200008,臺南市,新市區,大社里,684,394,472,1255,212,-861,44.915,-68.606
67000200009,臺南市,新市區,潭頂里,296,132,203,472,93,-340,45.813,-72.034
67000200010,臺南市,新市區,港墘里,604,298,358,811,246,-513,68.715,-63.255
67000200011,臺南市,新市區,永就里,574,279,442,795,132,-516,29.864,-64.906
67000310001,臺南市,永康區,五王里,1064,469,889,1317,175,-848,19.685,-64.389
67000310032,臺南市,永康區,三合里,654,266,585,814,69,-548,11.795,-67.322
67000310031,臺南市,永康區,六合里,1122,539,967,1285,155,-746,16.029,-58.054
67000310002,臺南市,永康區,網寮里,1285,568,1043,1697,242,-1129,23.202,-66.529
67000310030,臺南市,永康區,二王里,1555,600,1383,1770,172,-1170,12.437,-66.102
67000310003,臺南市,永康區,永康里,1372,634,1174,1903,198,-1269,16.865,-66.684
67000310004,臺南市,永康區,埔園里,1385,673,1004,1853,381,-1180,37.948,-63.681
67000310041,臺南市,永康區,龍埔里,782,335,520,931,262,-596,50.385,-64.017
67000310038,臺南市,永康區,正強里,1226,600,1098,1931,128,-1331,11.658,-68.928
67000310005,臺南市,永康區,大橋里,1097,486,998,1332,99,-846,9.92,-63.514
67000310033,臺南市,永康區,東橋里,1428,729,1028,1773,400,-1044,38.911,-58.883
67000310035,臺南市,永康區,西橋里,562,276,464,778,98,-502,21.121,-64.524
67000310034,臺南市,永康區,安康里,906,441,740,1122,166,-681,22.432,-60.695
67000310008,臺南市,永康區,蔦松里,315,167,210,499,105,-332,50.0,-66.533
67000310009,臺南市,永康區,三民里,317,121,240,413,77,-292,32.083,-70.702
67000310010,臺南市,永康區,塩行里,888,463,645,1417,243,-954,37.674,-67.325
67000310043,臺南市,永康區,塩興里,693,304,521,830,172,-526,33.013,-63.373
67000310029,臺南市,永康區,塩洲里,1020,571,836,1542,184,-971,22.01,-62.97
67000310011,臺南市,永康區,甲頂里,366,266,308,674,58,-408,18.831,-60.534
67000310036,臺南市,永康區,尚頂里,665,339,547,1098,118,-759,21.572,-69.126
67000310027,臺南市,永康區,龍潭里,967,511,687,1613,280,-1102,40.757,-68.32
67000310042,臺南市,永康區,永明里,947,388,795,1063,152,-675,19.119,-63.5
67000310006,臺南市,永康區,王行里,391,238,279,723,112,-485,40.143,-67.082
67000310007,臺南市,永康區,烏竹里,550,279,375,717,175,-438,46.667,-61.088
67000310023,臺南市,永康區,西勢里,1103,569,811,1612,292,-1043,36.005,-64.702
67000310018,臺南市,永康區,新樹里,323,216,255,568,68,-352,26.667,-61.972
67000310012,臺南市,永康區,大灣里,498,364,382,1030,116,-666,30.366,-64.66
67000310013,臺南市,永康區,東灣里,522,366,386,1039,136,-673,35.233,-64.774
67000310014,臺南市,永康區,西灣里,1358,715,1043,1956,315,-1241,30.201,-63.446
67000310015,臺南市,永康區,南灣里,575,422,439,1129,136,-707,30.979,-62.622
67000310016,臺南市,永康區,崑山里,991,590,844,1673,147,-1083,17.417,-64.734
67000310017,臺南市,永康區,北灣里,732,412,522,1133,210,-721,40.23,-63.636
67000310040,臺南市,永康區,北興里,992,535,738,1300,254,-765,34.417,-58.846
67000310019,臺南市,永康區,復興里,399,83,468,240,-69,-157,-14.744,-65.417
67000310028,臺南市,永康區,光復里,277,79,137,58,140,21,102.19,36.207
67000310021,臺南市,永康區,建國里,551,128,442,327,109,-199,24.661,-60.856
67000310020,臺南市,永康區,復國里,1932,553,1731,1587,201,-1034,11.612,-65.154
67000310037,臺南市,永康區,復華里,2027,622,1790,1855,237,-1233,13.24,-66.469
67000310022,臺南市,永康區,神洲里,278,82,235,232,43,-150,18.298,-64.655
67000310024,臺南市,永康區,成功里,570,105,580,254,-10,-149,-1.724,-58.661
67000310039,臺南市,永康區,中華里,759,236,665,666,94,-430,14.135,-64.565
67000310025,臺南市,永康區,中興里,674,251,694,695,-20,-444,-2.882,-63.885
67000310026,臺南市,永康區,勝利里,1690,660,1452,1508,238,-848,16.391,-56.233
67000180001,臺南市,新化區,武安里,625,263,553,797,72,-534,13.02,-67.001
67000180002,臺南市,新化區,東榮里,707,309,609,967,98,-658,16.092,-68.046
67000180003,臺南市,新化區,護國里,440,195,419,661,21,-466,5.012,-70.499
67000180004,臺南市,新化區,太平里,813,387,662,1171,151,-784,22.81,-66.951
67000180009,臺南市,新化區,協興里,599,242,492,792,107,-550,21.748,-69.444
67000180010,臺南市,新化區,唪口里,380,161,282,569,98,-408,34.752,-71.705
67000180011,臺南市,新化區,北勢里,248,143,189,370,59,-227,31.217,-61.351
67000180012,臺南市,新化區,豐榮里,595,246,478,725,117,-479,24.477,-66.069
67000180013,臺南市,新化區,全興里,553,229,468,622,85,-393,18.162,-63.183
67000180014,臺南市,新化區,崙頂里,336,200,250,595,86,-395,34.4,-66.387
67000180015,臺南市,新化區,知義里,315,201,295,538,20,-337,6.78,-62.639
67000180016,臺南市,新化區,山脚里,328,178,181,386,147,-208,81.215,-53.886
67000180017,臺南市,新化區,大坑里,44,38,36,124,8,-86,22.222,-69.355
67000180018,臺南市,新化區,𦰡拔里,369,126,278,458,91,-332,32.734,-72.489
67000180019,臺南市,新化區,羊林里,145,64,133,221,12,-157,9.023,-71.041
67000180020,臺南市,新化區,礁坑里,82,113,65,310,17,-197,26.154,-63.548
67000360009,臺南市,安平區,文平里,1120,540,953,1302,167,-762,17.524,-58.525
67000360005,臺南市,安平區,建平里,998,464,817,1280,181,-816,22.154,-63.75
67000360006,臺南市,安平區,怡平里,871,383,669,1014,202,-631,30.194,-62.229
67000360007,臺南市,安平區,華平里,933,413,810,1204,123,-791,15.185,-65.698
67000360008,臺南市,安平區,平通里,1307,586,1082,1631,225,-1045,20.795,-64.071
67000360012,臺南市,安平區,億載里,618,321,501,807,117,-486,23.353,-60.223
67000360011,臺南市,安平區,育平里,1566,630,1319,1640,247,-1010,18.726,-61.585
67000360010,臺南市,安平區,國平里,1769,774,1264,1798,505,-1024,39.953,-56.952
67000360004,臺南市,安平區,漁光里,60,39,63,134,-3,-95,-4.762,-70.896
67000360015,臺南市,安平區,平安里,558,318,497,950,61,-632,12.274,-66.526
67000360016,臺南市,安平區,天妃里,465,329,458,926,7,-597,1.528,-64.471
67000360017,臺南市,安平區,王城里,429,233,366,717,63,-484,17.213,-67.503
67000360002,臺南市,安平區,金城里,417,156,344,477,73,-321,21.221,-67.296
67000370005,臺南市,中西區,赤嵌里,542,401,580,1079,-38,-678,-6.552,-62.836
67000370007,臺南市,中西區,郡王里,506,331,537,788,-31,-457,-5.773,-57.995
67000370009,臺南市,中西區,法華里,506,292,527,711,-21,-419,-3.985,-58.931
67000370011,臺南市,中西區,開山里,351,277,321,680,30,-403,9.346,-59.265
67000370016,臺南市,中西區,永華里,409,269,430,702,-21,-433,-4.884,-61.681
67000370022,臺南市,中西區,藥王里,520,352,488,980,32,-628,6.557,-64.082
67000370025,臺南市,中西區,光賢里,640,437,537,1087,103,-650,19.181,-59.798
67000370031,臺南市,中西區,大涼里,499,250,430,692,69,-442,16.047,-63.873
67000370033,臺南市,中西區,西湖里,1246,635,1104,1524,142,-889,12.862,-58.333
67000370034,臺南市,中西區,西賢里,1002,514,935,1391,67,-877,7.166,-63.048
67000370039,臺南市,中西區,城隍里,524,404,564,1088,-40,-684,-7.092,-62.868
67000370040,臺南市,中西區,南美里,451,315,464,910,-13,-595,-2.802,-65.385
67000370041,臺南市,中西區,南門里,490,235,522,657,-32,-422,-6.13,-64.231
67000370042,臺南市,中西區,小西門里,566,340,569,778,-3,-438,-0.527,-56.298
67000370043,臺南市,中西區,五條港里,307,247,306,568,1,-321,0.327,-56.514
67000370044,臺南市,中西區,兌悅里,554,378,480,1090,74,-712,15.417,-65.321
67000370045,臺南市,中西區,淺草里,381,210,381,690,0,-480,0.0,-69.565
67000370046,臺南市,中西區,府前里,323,185,273,558,50,-373,18.315,-66.846
67000370047,臺南市,中西區,南廠里,556,440,564,1137,-8,-697,-1.418,-61.302
67000370048,臺南市,中西區,西和里,778,422,651,1122,127,-700,19.508,-62.389
67000330023,臺南市,南區,大恩里,742,292,655,799,87,-507,13.282,-63.454
67000330021,臺南市,南區,大林里,510,216,511,527,-1,-311,-0.196,-59.013
67000330022,臺南市,南區,大忠里,939,446,881,1138,58,-692,6.583,-60.808
67000330024,臺南市,南區,新生里,1013,188,1046,456,-33,-268,-3.155,-58.772
67000330001,臺南市,南區,竹溪里,362,194,387,438,-25,-244,-6.46,-55.708
67000330003,臺南市,南區,明德里,269,140,260,286,9,-146,3.462,-51.049
67000330004,臺南市,南區,大成里,384,219,335,463,49,-244,14.627,-52.7
67000330008,臺南市,南區,田寮里,582,358,547,831,35,-473,6.399,-56.919
67000330007,臺南市,南區,新興里,435,294,450,793,-15,-499,-3.333,-62.926
67000330025,臺南市,南區,再興里,402,257,371,681,31,-424,8.356,-62.261
67000330005,臺南市,南區,廣州里,346,268,356,725,-10,-457,-2.809,-63.034
67000330006,臺南市,南區,新昌里,400,242,358,597,42,-355,11.732,-59.464
67000330027,臺南市,南區,文華里,582,340,566,922,16,-582,2.827,-63.124
67000330035,臺南市,南區,文南里,950,529,827,1453,123,-924,14.873,-63.593
67000330028,臺南市,南區,金華里,842,507,776,1339,66,-832,8.505,-62.136
67000330009,臺南市,南區,國宅里,477,272,412,824,65,-552,15.777,-66.99
67000330040,臺南市,南區,鹽埕里,568,443,505,1164,63,-721,12.475,-61.942
67000330011,臺南市,南區,光明里,648,507,548,1223,100,-716,18.248,-58.545
67000330013,臺南市,南區,明亮里,619,368,512,1081,107,-713,20.898,-65.957
67000330034,臺南市,南區,府南里,876,459,699,1228,177,-769,25.322,-62.622
67000330026,臺南市,南區,明興里,478,330,418,1018,60,-688,14.354,-67.583
67000330033,臺南市,南區,郡南里,613,384,536,1020,77,-636,14.366,-62.353
67000330032,臺南市,南區,建南里,912,622,733,1574,179,-952,24.42,-60.483
67000330029,臺南市,南區,南都里,426,209,340,589,86,-380,25.294,-64.516
67000330039,臺南市,南區,南華里,378,253,335,645,43,-392,12.836,-60.775
67000330030,臺南市,南區,開南里,993,567,830,1539,163,-972,19.639,-63.158
67000330031,臺南市,南區,彰南里,217,128,225,431,-8,-303,-3.556,-70.302
67000330036,臺南市,南區,鯤鯓里,265,172,230,456,35,-284,15.217,-62.281
67000330015,臺南市,南區,喜北里,274,211,216,739,58,-528,26.852,-71.448
67000330016,臺南市,南區,喜南里,136,146,111,430,25,-284,22.523,-66.047
67000330014,臺南市,南區,喜東里,284,246,217,689,67,-443,30.876,-64.296
67000330017,臺南市,南區,省躬里,537,409,377,1096,160,-687,42.44,-62.682
67000330038,臺南市,南區,永寧里,212,219,195,573,17,-354,8.718,-61.78
67000330037,臺南市,南區,松安里,225,222,205,609,20,-387,9.756,-63.547
67000330020,臺南市,南區,佛壇里,354,318,231,829,123,-511,53.247,-61.641
67000330019,臺南市,南區,同安里,271,238,258,682,13,-444,5.039,-65.103
67000330018,臺南市,南區,興農里,504,335,293,807,211,-472,72.014,-58.488
67000320040,臺南市,東區,崇信里,590,299,594,966,-4,-667,-0.673,-69.048
67000320004,臺南市,東區,崇學里,549,242,531,754,18,-512,3.39,-67.905
67000320023,臺南市,東區,大學里,177,135,236,284,-59,-149,-25.0,-52.465
67000320037,臺南市,東區,成大里,393,166,392,441,1,-275,0.255,-62.358
67000320036,臺南市,東區,東門里,318,205,338,493,-20,-288,-5.917,-58.418
67000320021,臺南市,東區,圍下里,318,202,351,511,-33,-309,-9.402,-60.47
67000320010,臺南市,東區,中西里,590,295,603,737,-13,-442,-2.156,-59.973
67000320011,臺南市,東區,東安里,191,125,202,335,-11,-210,-5.446,-62.687
67000320029,臺南市,東區,忠孝里,940,364,915,1021,25,-657,2.732,-64.349
67000320028,臺南市,東區,大福里,313,143,301,430,12,-287,3.987,-66.744
67000320016,臺南市,東區,大德里,284,161,265,391,19,-230,7.17,-58.824
67000320015,臺南市,東區,路東里,346,162,360,375,-14,-213,-3.889,-56.8
67000320038,臺南市,東區,大同里,508,284,534,711,-26,-427,-4.869,-60.056
67000320005,臺南市,東區,泉南里,887,498,842,1221,45,-723,5.344,-59.214
67000320024,臺南市,東區,龍山里,929,471,899,1254,30,-783,3.337,-62.44
67000320039,臺南市,東區,德光里,798,397,838,1041,-40,-644,-4.773,-61.864
67000320032,臺南市,東區,崇德里,947,382,961,1117,-14,-735,-1.457,-65.801
67000320019,臺南市,東區,崇善里,967,504,856,1341,111,-837,12.967,-62.416
67000320035,臺南市,東區,崇成里,565,247,563,706,2,-459,0.355,-65.014
67000320041,臺南市,東區,崇文里,1217,506,1199,1393,18,-887,1.501,-63.676
67000320033,臺南市,東區,東智里,729,312,549,650,180,-338,32.787,-52.0
67000320003,臺南市,東區,大智里,1455,516,1372,1427,83,-911,6.05,-63.84
67000320026,臺南市,東區,德高里,711,326,542,874,169,-548,31.181,-62.7
67000320006,臺南市,東區,仁和里,1006,441,810,1068,196,-627,24.198,-58.708
67000320014,臺南市,東區,和平里,1083,490,874,1238,209,-748,23.913,-60.42
67000320025,臺南市,東區,虎尾里,1019,479,933,1338,86,-859,9.218,-64.2
67000320043,臺南市,東區,裕聖里,1188,354,1050,1060,138,-706,13.143,-66.604
67000320042,臺南市,東區,復興里,611,341,533,932,78,-591,14.634,-63.412
67000320013,臺南市,東區,自強里,1114,544,948,1229,166,-685,17.511,-55.736
67000320034,臺南市,東區,東聖里,397,213,388,548,9,-335,2.32,-61.131
67000320017,臺南市,東區,關聖里,984,353,988,1086,-4,-733,-0.405,-67.495
67000320044,臺南市,東區,南聖里,572,216,534,597,38,-381,7.116,-63.819
67000320045,臺南市,東區,文聖里,955,345,892,1061,63,-716,7.063,-67.484
67000320007,臺南市,東區,後甲里,538,262,483,707,55,-445,11.387,-62.942
67000320008,臺南市,東區,東光里,1006,432,1018,1178,-12,-746,-1.179,-63.328
67000320031,臺南市,東區,東明里,587,254,610,727,-23,-473,-3.77,-65.062
67000320027,臺南市,東區,莊敬里,760,359,703,848,57,-489,8.108,-57.665
67000320022,臺南市,東區,小東里,913,340,885,949,28,-609,3.164,-64.173
67000320009,臺南市,東區,新東里,502,292,531,624,-29,-332,-5.461,-53.205
67000320030,臺南市,東區,崇誨里,554,198,571,533,-17,-335,-2.977,-62.852
67000320018,臺南市,東區,衛國里,297,158,269,383,28,-225,10.409,-58.747
67000320002,臺南市,東區,裕農里,535,258,537,760,-2,-502,-0.372,-66.053
67000320020,臺南市,東區,富強里,831,440,762,1172,69,-732,9.055,-62.457
67000320001,臺南市,東區,富裕里,395,251,361,603,34,-352,9.418,-58.375
67000320012,臺南市,東區,崇明里,893,312,872,948,21,-636,2.408,-67.089
67000270001,臺南市,仁德區,太子里,929,601,694,1707,235,-1106,33.862,-64.792
67000270002,臺南市,仁德區,土庫里,430,348,315,929,115,-581,36.508,-62.54
67000270003,臺南市,仁德區,一甲里,468,218,398,716,70,-498,17.588,-69.553
67000270004,臺南市,仁德區,仁德里,1746,733,1181,1863,565,-1130,47.841,-60.655
67000270005,臺南市,仁德區,仁義里,1743,858,1468,2456,275,-1598,18.733,-65.065
67000270006,臺南市,仁德區,新田里,663,359,472,997,191,-638,40.466,-63.992
67000270007,臺南市,仁德區,後壁里,1747,931,1362,2427,385,-1496,28.267,-61.64
67000270008,臺南市,仁德區,上崙里,1088,575,776,1578,312,-1003,40.206,-63.561
67000270019,臺南市,仁德區,文賢里,418,200,314,599,104,-399,33.121,-66.611
67000270011,臺南市,仁德區,保安里,448,243,370,712,78,-469,21.081,-65.871
67000270012,臺南市,仁德區,成功里,1205,389,1065,1048,140,-659,13.146,-62.882
67000270013,臺南市,仁德區,仁和里,521,47,546,139,-25,-92,-4.579,-66.187
67000270014,臺南市,仁德區,仁愛里,301,74,304,226,-3,-152,-0.987,-67.257
67000270015,臺南市,仁德區,二行里,378,177,288,532,90,-355,31.25,-66.729
67000270016,臺南市,仁德區,大甲里,385,221,269,613,116,-392,43.123,-63.948
67000270017,臺南市,仁德區,中洲里,424,223,350,719,74,-496,21.143,-68.985
67000280001,臺南市,歸仁區,南保里,1054,581,799,1625,255,-1044,31.915,-64.246
67000280018,臺南市,歸仁區,南興里,869,455,633,1134,236,-679,37.283,-59.877
67000280002,臺南市,歸仁區,六甲里,612,325,407,971,205,-646,50.369,-66.529
67000280020,臺南市,歸仁區,歸南里,408,213,299,663,109,-450,36.455,-67.873
67000280004,臺南市,歸仁區,後市里,526,278,429,910,97,-632,22.611,-69.451
67000280021,臺南市,歸仁區,文化里,534,266,426,796,108,-530,25.352,-66.583
67000280005,臺南市,歸仁區,辜厝里,572,295,490,848,82,-553,16.735,-65.212
67000280019,臺南市,歸仁區,新厝里,411,256,291,679,120,-423,41.237,-62.297
67000280006,臺南市,歸仁區,許厝里,575,324,434,883,141,-559,32.488,-63.307
67000280007,臺南市,歸仁區,看西里,396,239,276,657,120,-418,43.478,-63.623
67000280008,臺南市,歸仁區,看東里,397,163,266,491,131,-328,49.248,-66.802
67000280009,臺南市,歸仁區,崙頂里,537,302,400,961,137,-659,34.25,-68.574
67000280010,臺南市,歸仁區,沙崙里,333,115,92,185,241,-70,261.957,-37.838
67000280011,臺南市,歸仁區,大潭里,283,190,197,548,86,-358,43.655,-65.328
67000280012,臺南市,歸仁區,武東里,323,191,228,417,95,-226,41.667,-54.197
67000280003,臺南市,歸仁區,歸仁里,431,208,350,573,81,-365,23.143,-63.7
67000280013,臺南市,歸仁區,八甲里,512,288,377,805,135,-517,35.809,-64.224
67000280014,臺南市,歸仁區,七甲里,656,335,468,952,188,-617,40.171,-64.811
67000280015,臺南市,歸仁區,媽廟里,262,200,234,608,28,-408,11.966,-67.105
67000280016,臺南市,歸仁區,西埔里,336,203,228,510,108,-307,47.368,-60.196
67000280017,臺南市,歸仁區,大廟里,568,327,400,877,168,-550,42.0,-62.714
67000290001,臺南市,關廟區,關廟里,433,204,316,649,117,-445,37.025,-68.567
67000290002,臺南市,關廟區,山西里,362,174,264,592,98,-418,37.121,-70.608
67000290003,臺南市,關廟區,香洋里,535,289,510,928,25,-639,4.902,-68.858
67000290004,臺南市,關廟區,北勢里,396,255,294,746,102,-491,34.694,-65.818
67000290005,臺南市,關廟區,新埔里,187,99,108,261,79,-162,73.148,-62.069
67000290006,臺南市,關廟區,新光里,80,52,71,212,9,-160,12.676,-75.472
67000290007,臺南市,關廟區,五甲里,564,290,453,818,111,-528,24.503,-64.548
67000290008,臺南市,關廟區,東勢里,493,259,389,822,104,-563,26.735,-68.491
67000290009,臺南市,關廟區,松腳里,280,177,226,528,54,-351,23.894,-66.477
67000290018,臺南市,關廟區,花園里,533,307,403,981,130,-674,32.258,-68.705
67000290012,臺南市,關廟區,深坑里,302,128,215,375,87,-247,40.465,-65.867
67000290013,臺南市,關廟區,布袋里,169,93,124,350,45,-257,36.29,-73.429
67000290020,臺南市,關廟區,龜洞里,167,133,,,,,,
67000290016,臺南市,關廟區,埤頭里,297,211,227,543,70,-332,30.837,-61.142
67000290017,臺南市,關廟區,下湖里,80,47,72,133,8,-86,11.111,-64.662
67000300001,臺南市,龍崎區,崎頂里,152,71,118,256,34,-185,28.814,-72.266
67000300002,臺南市,龍崎區,土崎里,72,28,69,144,3,-116,4.348,-80.556
67000300003,臺南市,龍崎區,中坑里,22,9,20,32,2,-23,10.0,-71.875
67000300004,臺南市,龍崎區,楠坑里,67,27,56,103,11,-76,19.643,-73.786
67000300006,臺南市,龍崎區,大坪里,60,19,63,61,-3,-42,-4.762,-68.852
67000300008,臺南市,龍崎區,石𥕢里,55,18,50,85,5,-67,10.0,-78.824
67000300007,臺南市,龍崎區,龍船里,71,15,64,54,7,-39,10.938,-72.222
67000300005,臺南市,龍崎區,牛埔里,47,17,51,78,-4,-61,-7.843,-78.205
10007010032,彰化縣,彰化市,桃源里,546,163,466,495,80,-332,17.167,-67.071
10007010034,彰化縣,彰化市,東興里,340,113,317,359,23,-246,7.256,-68.524
10007010038,彰化縣,彰化市,華北里,375,105,323,311,52,-206,16.099,-66.238
10007010037,彰化縣,彰化市,華陽里,408,85,407,339,1,-254,0.246,-74.926
10007010035,彰化縣,彰化市,大同里,209,68,208,246,1,-178,0.481,-72.358
10007010036,彰化縣,彰化市,永生里,263,98,266,278,-3,-180,-1.128,-64.748
10007010048,彰化縣,彰化市,建寶里,566,126,550,469,16,-343,2.909,-73.134
10007010045,彰化縣,彰化市,光南里,315,91,317,321,-2,-230,-0.631,-71.651
10007010046,彰化縣,彰化市,介壽里,515,128,565,395,-50,-267,-8.85,-67.595
10007010047,彰化縣,彰化市,延平里,2171,595,1906,1867,265,-1272,13.903,-68.131
10007010041,彰化縣,彰化市,延和里,1191,342,1020,1064,171,-722,16.765,-67.857
10007010042,彰化縣,彰化市,南興里,1857,567,1487,1641,370,-1074,24.882,-65.448
10007010039,彰化縣,彰化市,南瑶里,1784,485,1580,1657,204,-1172,12.911,-70.73
10007010040,彰化縣,彰化市,成功里,325,103,320,336,5,-233,1.562,-69.345
10007010049,彰化縣,彰化市,福安里,255,88,212,237,43,-149,20.283,-62.869
10007010043,彰化縣,彰化市,西安里,618,186,582,642,36,-456,6.186,-71.028
10007010044,彰化縣,彰化市,彰安里,591,218,583,669,8,-451,1.372,-67.414
10007010017,彰化縣,彰化市,中央里,146,75,153,221,-7,-146,-4.575,-66.063
10007010018,彰化縣,彰化市,富貴里,166,63,143,244,23,-181,16.084,-74.18
10007010019,彰化縣,彰化市,民權里,223,73,215,250,8,-177,3.721,-70.8
10007010016,彰化縣,彰化市,萬壽里,160,99,133,250,27,-151,20.301,-60.4
10007010025,彰化縣,彰化市,長樂里,176,71,184,274,-8,-203,-4.348,-74.088
10007010020,彰化縣,彰化市,西興里,850,241,703,767,147,-526,20.91,-68.579
10007010021,彰化縣,彰化市,西勢里,849,199,812,743,37,-544,4.557,-73.217
10007010023,彰化縣,彰化市,忠權里,746,167,675,653,71,-486,10.519,-74.426
10007010022,彰化縣,彰化市,忠孝里,271,83,257,271,14,-188,5.447,-69.373
10007010024,彰化縣,彰化市,五權里,906,199,767,758,139,-559,18.123,-73.747
10007010031,彰化縣,彰化市,平和里,1000,256,827,852,173,-596,20.919,-69.953
10007010072,彰化縣,彰化市,崙平里,1192,366,1153,1102,39,-736,3.382,-66.788
10007010073,彰化縣,彰化市,向陽里,1418,286,1188,996,230,-710,19.36,-71.285
10007010029,彰化縣,彰化市,莿桐里,690,216,632,689,58,-473,9.177,-68.65
10007010028,彰化縣,彰化市,南美里,456,87,333,401,123,-314,36.937,-78.304
10007010027,彰化縣,彰化市,南安里,499,148,440,444,59,-296,13.409,-66.667
10007010026,彰化縣,彰化市,東芳里,775,225,634,756,141,-531,22.24,-70.238
10007010030,彰化縣,彰化市,磚磘里,795,170,628,640,167,-470,26.592,-73.438
10007010033,彰化縣,彰化市,卦山里,586,186,581,509,5,-323,0.861,-63.458
10007010014,彰化縣,彰化市,光復里,112,45,91,171,21,-126,23.077,-73.684
10007010013,彰化縣,彰化市,永福里,170,87,162,234,8,-147,4.938,-62.821
10007010015,彰化縣,彰化市,光華里,177,78,158,203,19,-125,12.025,-61.576
10007010012,彰化縣,彰化市,中正里,301,98,330,311,-29,-213,-8.788,-68.489
10007010011,彰化縣,彰化市,中山里,217,51,197,148,20,-97,10.152,-65.541
10007010010,彰化縣,彰化市,龍山里,440,111,390,441,50,-330,12.821,-74.83
10007010008,彰化縣,彰化市,新興里,1228,417,1044,1223,184,-806,17.625,-65.904
10007010009,彰化縣,彰化市,新華里,440,118,381,382,59,-264,15.486,-69.11
10007010003,彰化縣,彰化市,興北里,340,118,306,372,34,-254,11.111,-68.28
10007010004,彰化縣,彰化市,信義里,180,57,177,199,3,-142,1.695,-71.357
10007010005,彰化縣,彰化市,民生里,258,109,295,279,-37,-170,-12.542,-60.932
10007010001,彰化縣,彰化市,文化里,259,90,255,275,4,-185,1.569,-67.273
10007010006,彰化縣,彰化市,陽明里,369,129,346,399,23,-270,6.647,-67.669
10007010007,彰化縣,彰化市,萬安里,824,287,808,912,16,-625,1.98,-68.531
10007010002,彰化縣,彰化市,下廍里,1240,303,1064,1058,176,-755,16.541,-71.361
10007010060,彰化縣,彰化市,茄苳里,240,48,190,191,50,-143,26.316,-74.869
10007010061,彰化縣,彰化市,茄南里,716,167,613,626,103,-459,16.803,-73.323
10007010059,彰化縣,彰化市,寶廍里,254,70,217,263,37,-193,17.051,-73.384
10007010063,彰化縣,彰化市,古夷里,548,155,419,510,129,-355,30.788,-69.608
10007010062,彰化縣,彰化市,阿夷里,2011,425,1746,1599,265,-1174,15.178,-73.421
10007010065,彰化縣,彰化市,和調里,595,175,562,564,33,-389,5.872,-68.972
10007010064,彰化縣,彰化市,復興里,964,302,909,864,55,-562,6.051,-65.046
10007010056,彰化縣,彰化市,中庄里,462,157,436,525,26,-368,5.963,-70.095
10007010051,彰化縣,彰化市,竹中里,384,95,329,305,55,-210,16.717,-68.852
10007010053,彰化縣,彰化市,香山里,672,175,603,705,69,-530,11.443,-75.177
10007010054,彰化縣,彰化市,牛埔里,615,197,545,694,70,-497,12.844,-71.614
10007010071,彰化縣,彰化市,台鳳里,1087,219,912,755,175,-536,19.189,-70.993
10007010058,彰化縣,彰化市,國聖里,602,172,453,563,149,-391,32.892,-69.449
10007010055,彰化縣,彰化市,福山里,1421,411,1230,1482,191,-1071,15.528,-72.267
10007010052,彰化縣,彰化市,安溪里,468,122,386,401,82,-279,21.244,-69.576
10007010057,彰化縣,彰化市,三村里,220,53,209,227,11,-174,5.263,-76.652
10007010050,彰化縣,彰化市,大竹里,773,176,635,680,138,-504,21.732,-74.118
10007010069,彰化縣,彰化市,田中里,196,53,182,178,14,-125,7.692,-70.225
10007010070,彰化縣,彰化市,快官里,219,83,211,248,8,-165,3.791,-66.532
10007010068,彰化縣,彰化市,竹巷里,163,54,134,188,29,-134,21.642,-71.277
10007010067,彰化縣,彰化市,福田里,270,53,223,246,47,-193,21.076,-78.455
10007010066,彰化縣,彰化市,石牌里,205,54,201,215,4,-161,1.99,-74.884
10007080001,彰化縣,花壇鄉,花壇村,787,189,663,662,124,-473,18.703,-71.45
10007080002,彰化縣,花壇鄉,金墩村,419,105,317,359,102,-254,32.177,-70.752
10007080003,彰化縣,花壇鄉,中庄村,484,119,463,459,21,-340,4.536,-74.074
10007080005,彰化縣,花壇鄉,崙雅村,281,92,239,319,42,-227,17.573,-71.16
10007080004,彰化縣,花壇鄉,劉厝村,212,64,189,267,23,-203,12.169,-76.03
10007080006,彰化縣,花壇鄉,南口村,439,92,369,378,70,-286,18.97,-75.661
10007080008,彰化縣,花壇鄉,北口村,472,126,362,368,110,-242,30.387,-65.761
10007080007,彰化縣,花壇鄉,中口村,138,46,129,165,9,-119,6.977,-72.121
10007080010,彰化縣,花壇鄉,文德村,732,191,560,578,172,-387,30.714,-66.955
10007080011,彰化縣,花壇鄉,白沙村,1094,216,896,811,198,-595,22.098,-73.366
10007080012,彰化縣,花壇鄉,岩竹村,241,74,207,312,34,-238,16.425,-76.282
10007080009,彰化縣,花壇鄉,長沙村,1148,246,1000,881,148,-635,14.8,-72.077
10007080013,彰化縣,花壇鄉,橋頭村,761,142,604,549,157,-407,25.993,-74.135
10007080014,彰化縣,花壇鄉,灣雅村,228,42,177,133,51,-91,28.814,-68.421
10007080015,彰化縣,花壇鄉,灣東村,178,42,158,181,20,-139,12.658,-76.796
10007080016,彰化縣,花壇鄉,三春村,430,115,346,318,84,-203,24.277,-63.836
10007080017,彰化縣,花壇鄉,永春村,482,66,314,266,168,-200,53.503,-75.188
10007080018,彰化縣,花壇鄉,長春村,331,54,272,219,59,-165,21.691,-75.342
10007090001,彰化縣,芬園鄉,舊社村,325,59,283,304,42,-245,14.841,-80.592
10007090002,彰化縣,芬園鄉,大埔村,278,59,222,249,56,-190,25.225,-76.305
10007090003,彰化縣,芬園鄉,竹林村,405,85,336,341,69,-256,20.536,-75.073
10007090015,彰化縣,芬園鄉,楓坑村,113,25,101,100,12,-75,11.881,-75.0
10007090004,彰化縣,芬園鄉,社口村,499,94,395,463,104,-369,26.329,-79.698
10007090005,彰化縣,芬園鄉,茄荖村,491,133,380,512,111,-379,29.211,-74.023
10007090006,彰化縣,芬園鄉,嘉興村,375,84,356,304,19,-220,5.337,-72.368
10007090007,彰化縣,芬園鄉,芬園村,125,44,130,171,-5,-127,-3.846,-74.269
10007090008,彰化縣,芬園鄉,縣庄村,219,48,166,246,53,-198,31.928,-80.488
10007090009,彰化縣,芬園鄉,圳墘村,94,39,88,130,6,-91,6.818,-70.0
10007090010,彰化縣,芬園鄉,溪頭村,298,127,263,367,35,-240,13.308,-65.395
10007090011,彰化縣,芬園鄉,進芬村,208,53,169,177,39,-124,23.077,-70.056
10007090012,彰化縣,芬園鄉,同安村,166,63,143,239,23,-176,16.084,-73.64
10007090013,彰化縣,芬園鄉,中崙村,112,33,101,155,11,-122,10.891,-78.71
10007090014,彰化縣,芬園鄉,大竹村,124,38,105,219,19,-181,18.095,-82.648
10007020001,彰化縣,鹿港鎮,大有里,168,73,175,291,-7,-218,-4.0,-74.914
10007020002,彰化縣,鹿港鎮,中興里,71,43,74,146,-3,-103,-4.054,-70.548
10007020003,彰化縣,鹿港鎮,洛津里,131,58,124,191,7,-133,5.645,-69.634
10007020004,彰化縣,鹿港鎮,順興里,172,66,138,239,34,-173,24.638,-72.385
10007020007,彰化縣,鹿港鎮,埔崙里,943,355,695,1225,248,-870,35.683,-71.02
10007020010,彰化縣,鹿港鎮,新宮里,144,70,140,259,4,-189,2.857,-72.973
10007020011,彰化縣,鹿港鎮,玉順里,165,69,155,292,10,-223,6.452,-76.37
10007020008,彰化縣,鹿港鎮,東石里,703,334,529,1067,174,-733,32.892,-68.697
10007020009,彰化縣,鹿港鎮,郭厝里,96,45,79,137,17,-92,21.519,-67.153
10007020029,彰化縣,鹿港鎮,永安里,752,265,646,922,106,-657,16.409,-71.258
10007020012,彰化縣,鹿港鎮,景福里,206,83,210,260,-4,-177,-1.905,-68.077
10007020013,彰化縣,鹿港鎮,泰興里,220,84,206,289,14,-205,6.796,-70.934
10007020014,彰化縣,鹿港鎮,長興里,48,20,56,67,-8,-47,-14.286,-70.149
10007020016,彰化縣,鹿港鎮,興化里,87,45,106,142,-19,-97,-17.925,-68.31
10007020015,彰化縣,鹿港鎮,龍山里,100,54,110,170,-10,-116,-9.091,-68.235
10007020017,彰化縣,鹿港鎮,菜園里,141,81,116,293,25,-212,21.552,-72.355
10007020018,彰化縣,鹿港鎮,街尾里,434,174,394,602,40,-428,10.152,-71.096
10007020027,彰化縣,鹿港鎮,詔安里,389,114,284,386,105,-272,36.972,-70.466
10007020026,彰化縣,鹿港鎮,海埔里,675,191,471,709,204,-518,43.312,-73.061
10007020028,彰化縣,鹿港鎮,洋厝里,438,142,379,514,59,-372,15.567,-72.374
10007020023,彰化縣,鹿港鎮,草中里,723,144,621,548,102,-404,16.425,-73.723
10007020024,彰化縣,鹿港鎮,頭南里,518,79,389,327,129,-248,33.162,-75.841
10007020025,彰化縣,鹿港鎮,山崙里,583,155,467,592,116,-437,24.839,-73.818
10007020019,彰化縣,鹿港鎮,頂番里,875,156,700,628,175,-472,25.0,-75.159
10007020020,彰化縣,鹿港鎮,頭崙里,568,95,441,460,127,-365,28.798,-79.348
10007020022,彰化縣,鹿港鎮,溝墘里,1062,192,758,696,304,-504,40.106,-72.414
10007020021,彰化縣,鹿港鎮,廖厝里,949,181,683,643,266,-462,38.946,-71.851
10007020006,彰化縣,鹿港鎮,東崎里,1067,272,760,1053,307,-781,40.395,-74.169
10007020031,彰化縣,鹿港鎮,鹿東里,472,168,,,,,,
10007020005,彰化縣,鹿港鎮,頂厝里,625,193,1183,1693,-558,-1500,-47.168,-88.6
10007020030,彰化縣,鹿港鎮,鹿和里,463,143,,,,,,
10007060007,彰化縣,福興鄉,三汴村,261,81,214,324,47,-243,21.963,-75.0
10007060008,彰化縣,福興鄉,萬豐村,188,74,140,227,48,-153,34.286,-67.401
10007060006,彰化縣,福興鄉,元中村,273,55,196,257,77,-202,39.286,-78.599
10007060005,彰化縣,福興鄉,外中村,200,97,147,274,53,-177,36.054,-64.599
10007060004,彰化縣,福興鄉,外埔村,276,81,194,314,82,-233,42.268,-74.204
10007060003,彰化縣,福興鄉,大崙村,276,69,195,252,81,-183,41.538,-72.619
10007060009,彰化縣,福興鄉,番婆村,453,86,548,176,-95,-90,-17.336,-51.136
10007060010,彰化縣,福興鄉,橋頭村,479,120,413,525,66,-405,15.981,-77.143
10007060002,彰化縣,福興鄉,社尾村,267,64,198,293,69,-229,34.848,-78.157
10007060001,彰化縣,福興鄉,番社村,235,107,169,362,66,-255,39.053,-70.442
10007060022,彰化縣,福興鄉,西勢村,354,103,309,380,45,-277,14.563,-72.895
10007060021,彰化縣,福興鄉,同安村,362,107,318,430,44,-323,13.836,-75.116
10007060011,彰化縣,福興鄉,秀厝村,478,120,325,485,153,-365,47.077,-75.258
10007060019,彰化縣,福興鄉,福興村,658,209,510,784,148,-575,29.02,-73.342
10007060020,彰化縣,福興鄉,福南村,489,103,369,449,120,-346,32.52,-77.06
10007060012,彰化縣,福興鄉,鎮平村,259,42,186,184,73,-142,39.247,-77.174
10007060013,彰化縣,福興鄉,三和村,155,60,109,272,46,-212,42.202,-77.941
10007060018,彰化縣,福興鄉,二港村,253,77,182,274,71,-197,39.011,-71.898
10007060017,彰化縣,福興鄉,福寶村,242,43,181,150,61,-107,33.702,-71.333
10007060016,彰化縣,福興鄉,頂粘村,497,58,334,314,163,-256,48.802,-81.529
10007060015,彰化縣,福興鄉,廈粘村,356,67,295,293,61,-226,20.678,-77.133
10007060014,彰化縣,福興鄉,麥厝村,282,97,239,392,43,-295,17.992,-75.255
10007070001,彰化縣,秀水鄉,秀水村,372,131,275,412,97,-281,35.273,-68.204
10007070002,彰化縣,秀水鄉,安溪村,428,162,364,487,64,-325,17.582,-66.735
10007070003,彰化縣,秀水鄉,莊雅村,603,150,550,490,53,-340,9.636,-69.388
10007070005,彰化縣,秀水鄉,陝西村,337,58,268,235,69,-177,25.746,-75.319
10007070004,彰化縣,秀水鄉,金興村,442,93,330,306,112,-213,33.939,-69.608
10007070006,彰化縣,秀水鄉,安東村,891,195,729,755,162,-560,22.222,-74.172
10007070007,彰化縣,秀水鄉,鶴鳴村,714,195,585,688,129,-493,22.051,-71.657
10007070008,彰化縣,秀水鄉,馬興村,521,135,386,509,135,-374,34.974,-73.477
10007070009,彰化縣,秀水鄉,義興村,330,54,238,266,92,-212,38.655,-79.699
10007070010,彰化縣,秀水鄉,福安村,1157,284,791,894,366,-610,46.271,-68.233
10007070011,彰化縣,秀水鄉,埔崙村,423,112,375,465,48,-353,12.8,-75.914
10007070012,彰化縣,秀水鄉,曾厝村,412,97,293,341,119,-244,40.614,-71.554
10007070013,彰化縣,秀水鄉,金陵村,346,102,264,403,82,-301,31.061,-74.69
10007070014,彰化縣,秀水鄉,下崙村,442,120,308,464,134,-344,43.506,-74.138
10007030001,彰化縣,和美鎮,竹營里,1266,253,1075,1065,191,-812,17.767,-76.244
10007030002,彰化縣,和美鎮,和東里,1048,222,789,857,259,-635,32.826,-74.096
10007030003,彰化縣,和美鎮,和南里,103,25,99,82,4,-57,4.04,-69.512
10007030004,彰化縣,和美鎮,和北里,341,96,292,333,49,-237,16.781,-71.171
10007030005,彰化縣,和美鎮,和西里,616,143,589,626,27,-483,4.584,-77.157
10007030006,彰化縣,和美鎮,四張里,590,163,461,556,129,-393,27.983,-70.683
10007030007,彰化縣,和美鎮,頭前里,378,65,276,264,102,-199,36.957,-75.379
10007030009,彰化縣,和美鎮,面前里,557,97,349,453,208,-356,59.599,-78.587
10007030010,彰化縣,和美鎮,鎮平里,680,167,524,534,156,-367,29.771,-68.727
10007030011,彰化縣,和美鎮,大霞里,319,54,236,230,83,-176,35.169,-76.522
10007030012,彰化縣,和美鎮,源埤里,385,89,290,323,95,-234,32.759,-72.446
10007030013,彰化縣,和美鎮,南佃里,534,107,379,431,155,-324,40.897,-75.174
10007030014,彰化縣,和美鎮,雅溝里,287,64,201,256,86,-192,42.786,-75.0
10007030015,彰化縣,和美鎮,山犁里,1192,233,981,1025,211,-792,21.509,-77.268
10007030032,彰化縣,和美鎮,仁愛里,593,137,420,472,173,-335,41.19,-70.975
10007030016,彰化縣,和美鎮,嘉犁里,469,106,350,376,119,-270,34.0,-71.809
10007030018,彰化縣,和美鎮,詔安里,428,132,371,396,57,-264,15.364,-66.667
10007030017,彰化縣,和美鎮,鐵山里,644,168,492,568,152,-400,30.894,-70.423
10007030019,彰化縣,和美鎮,柑井里,711,176,526,659,185,-483,35.171,-73.293
10007030020,彰化縣,和美鎮,竹園里,219,61,140,217,79,-156,56.429,-71.889
10007030021,彰化縣,和美鎮,新庄里,563,118,471,493,92,-375,19.533,-76.065
10007030022,彰化縣,和美鎮,犁盛里,499,134,399,516,100,-382,25.063,-74.031
10007030023,彰化縣,和美鎮,中寮里,192,51,155,208,37,-157,23.871,-75.481
10007030024,彰化縣,和美鎮,中圍里,621,125,478,574,143,-449,29.916,-78.223
10007030025,彰化縣,和美鎮,糖友里,1082,222,812,744,270,-522,33.251,-70.161
10007030008,彰化縣,和美鎮,還社里,209,49,176,163,33,-114,18.75,-69.939
10007030026,彰化縣,和美鎮,塗厝里,369,54,311,278,58,-224,18.65,-80.576
10007030027,彰化縣,和美鎮,地潭里,161,29,135,109,26,-80,19.259,-73.394
10007030028,彰化縣,和美鎮,湖內里,207,59,173,273,34,-214,19.653,-78.388
10007030029,彰化縣,和美鎮,嘉寶里,422,74,283,344,139,-270,49.117,-78.488
10007030030,彰化縣,和美鎮,月眉里,606,174,490,634,116,-460,23.673,-72.555
10007030031,彰化縣,和美鎮,好修里,294,86,246,319,48,-233,19.512,-73.041
10007050012,彰化縣,伸港鄉,大同村,668,105,430,523,238,-418,55.349,-79.924
10007050007,彰化縣,伸港鄉,海尾村,416,57,334,329,82,-272,24.551,-82.675
10007050008,彰化縣,伸港鄉,全興村,429,42,322,178,107,-136,33.23,-76.404
10007050004,彰化縣,伸港鄉,溪底村,360,96,295,400,65,-304,22.034,-76.0
10007050009,彰化縣,伸港鄉,定興村,584,118,436,409,148,-291,33.945,-71.149
10007050011,彰化縣,伸港鄉,什股村,555,74,368,253,187,-179,50.815,-70.751
10007050005,彰化縣,伸港鄉,泉州村,493,94,355,322,138,-228,38.873,-70.807
10007050006,彰化縣,伸港鄉,泉厝村,290,42,231,227,59,-185,25.541,-81.498
10007050001,彰化縣,伸港鄉,曾家村,307,87,249,279,58,-192,23.293,-68.817
10007050002,彰化縣,伸港鄉,蚵寮村,148,66,126,290,22,-224,17.46,-77.241
10007050010,彰化縣,伸港鄉,新港村,1064,241,815,904,249,-663,30.552,-73.341
10007050003,彰化縣,伸港鄉,埤墘村,357,64,231,247,126,-183,54.545,-74.089
10007050013,彰化縣,伸港鄉,七嘉村,673,127,489,495,184,-368,37.628,-74.343
10007050014,彰化縣,伸港鄉,汴頭村,454,90,361,364,93,-274,25.762,-75.275
10007040001,彰化縣,線西鄉,線西村,551,114,270,165,281,-51,104.074,-30.909
10007040002,彰化縣,線西鄉,頂庄村,260,43,500,326,-240,-283,-48.0,-86.81
10007040003,彰化縣,線西鄉,寓埔村,561,121,420,359,141,-238,33.571,-66.295
10007040004,彰化縣,線西鄉,塭仔村,260,55,221,221,39,-166,17.647,-75.113
10007040005,彰化縣,線西鄉,溝內村,281,53,200,183,81,-130,40.5,-71.038
10007040006,彰化縣,線西鄉,下犁村,436,81,323,357,113,-276,34.985,-77.311
10007040007,彰化縣,線西鄉,頂犁村,606,91,434,363,172,-272,39.631,-74.931
10007040008,彰化縣,線西鄉,德興村,339,82,263,239,76,-157,28.897,-65.69
10007100025,彰化縣,員林市,崙雅里,530,107,463,413,67,-306,14.471,-74.092
10007100026,彰化縣,員林市,振興里,594,137,560,465,34,-328,6.071,-70.538
10007100027,彰化縣,員林市,林厝里,531,160,442,525,89,-365,20.136,-69.524
10007100028,彰化縣,員林市,出水里,295,69,211,371,84,-302,39.81,-81.402
10007100029,彰化縣,員林市,湖水里,183,80,160,269,23,-189,14.375,-70.26
10007100030,彰化縣,員林市,大峯里,180,26,161,118,19,-92,11.801,-77.966
10007100031,彰化縣,員林市,鎮興里,374,109,337,377,37,-268,10.979,-71.088
10007100032,彰化縣,員林市,浮圳里,448,90,366,404,82,-314,22.404,-77.723
10007100033,彰化縣,員林市,西東里,341,88,285,428,56,-340,19.649,-79.439
10007100034,彰化縣,員林市,南東里,345,91,284,327,61,-236,21.479,-72.171
10007100035,彰化縣,員林市,中東里,349,88,314,292,35,-204,11.146,-69.863
10007100036,彰化縣,員林市,東北里,489,102,401,433,88,-331,21.945,-76.443
10007100001,彰化縣,員林市,東和里,219,57,228,181,-9,-124,-3.947,-68.508
10007100002,彰化縣,員林市,民生里,585,144,547,534,38,-390,6.947,-73.034
10007100009,彰化縣,員林市,黎明里,336,101,331,350,5,-249,1.511,-71.143
10007100010,彰化縣,員林市,惠來里,1197,346,1058,1206,139,-860,13.138,-71.31
10007100020,彰化縣,員林市,中央里,445,126,301,386,144,-260,47.841,-67.358
10007100021,彰化縣,員林市,溝皂里,627,184,497,555,130,-371,26.157,-66.847
10007100022,彰化縣,員林市,大饒里,809,194,686,690,123,-496,17.93,-71.884
10007100023,彰化縣,員林市,大明里,423,149,384,509,39,-360,10.156,-70.727
10007100024,彰化縣,員林市,萬年里,953,231,819,708,134,-477,16.361,-67.373
10007100003,彰化縣,員林市,中正里,778,178,677,628,101,-450,14.919,-71.656
10007100004,彰化縣,員林市,仁美里,567,154,555,541,12,-387,2.162,-71.534
10007100005,彰化縣,員林市,新興里,146,55,152,184,-6,-129,-3.947,-70.109
10007100006,彰化縣,員林市,和平里,645,143,555,549,90,-406,16.216,-73.953
10007100007,彰化縣,員林市,光明里,154,44,173,176,-19,-132,-10.983,-75.0
10007100008,彰化縣,員林市,中山里,137,39,136,151,1,-112,0.735,-74.172
10007100017,彰化縣,員林市,三條里,667,157,509,549,158,-392,31.041,-71.403
10007100041,彰化縣,員林市,忠孝里,466,108,420,399,46,-291,10.952,-72.932
10007100040,彰化縣,員林市,仁愛里,307,92,281,283,26,-191,9.253,-67.491
10007100018,彰化縣,員林市,三和里,1389,338,1206,1160,183,-822,15.174,-70.862
10007100019,彰化縣,員林市,三橋里,687,161,616,571,71,-410,11.526,-71.804
10007100037,彰化縣,員林市,三愛里,731,194,620,619,111,-425,17.903,-68.659
10007100038,彰化縣,員林市,三信里,563,114,547,441,16,-327,2.925,-74.15
10007100039,彰化縣,員林市,三多里,693,225,525,583,168,-358,32.0,-61.407
10007100011,彰化縣,員林市,三義里,576,144,496,456,80,-312,16.129,-68.421
10007100012,彰化縣,員林市,新生里,915,300,842,905,73,-605,8.67,-66.851
10007100013,彰化縣,員林市,南平里,1312,344,1044,1074,268,-730,25.67,-67.97
10007100014,彰化縣,員林市,南興里,1100,285,937,887,163,-602,17.396,-67.869
10007100015,彰化縣,員林市,源潭里,353,91,235,339,118,-248,50.213,-73.156
10007100016,彰化縣,員林市,大埔里,450,100,349,390,101,-290,28.94,-74.359
10007130001,彰化縣,大村鄉,大村村,836,181,619,639,217,-458,35.057,-71.674
10007130002,彰化縣,大村鄉,茄苳村,317,86,274,309,43,-223,15.693,-72.168
10007130004,彰化縣,大村鄉,田洋村,292,47,221,213,71,-166,32.127,-77.934
10007130009,彰化縣,大村鄉,貢旗村,368,100,268,309,100,-209,37.313,-67.638
10007130003,彰化縣,大村鄉,南勢村,298,93,229,295,69,-202,30.131,-68.475
10007130012,彰化縣,大村鄉,大橋村,427,92,359,341,68,-249,18.942,-73.021
10007130010,彰化縣,大村鄉,加錫村,359,71,242,291,117,-220,48.347,-75.601
10007130013,彰化縣,大村鄉,大崙村,301,91,241,318,60,-227,24.896,-71.384
10007130005,彰化縣,大村鄉,新興村,206,49,149,232,57,-183,38.255,-78.879
10007130014,彰化縣,大村鄉,擺塘村,563,131,450,523,113,-392,25.111,-74.952
10007130006,彰化縣,大村鄉,過溝村,798,168,814,771,-16,-603,-1.966,-78.21
10007130011,彰化縣,大村鄉,村上村,325,102,268,276,57,-174,21.269,-63.043
10007130007,彰化縣,大村鄉,美港村,667,190,378,377,289,-187,76.455,-49.602
10007130015,彰化縣,大村鄉,黃厝村,498,148,349,439,149,-291,42.693,-66.287
10007130016,彰化縣,大村鄉,福興村,422,112,300,456,122,-344,40.667,-75.439
10007130008,彰化縣,大村鄉,平和村,538,128,397,465,141,-337,35.516,-72.473
10007160011,彰化縣,永靖鄉,浮圳村,220,39,166,198,54,-159,32.53,-80.303
10007160013,彰化縣,永靖鄉,東寧村,390,110,299,370,91,-260,30.435,-70.27
10007160012,彰化縣,永靖鄉,光雲村,301,111,224,328,77,-217,34.375,-66.159
10007160010,彰化縣,永靖鄉,五汴村,304,108,198,364,106,-256,53.535,-70.33
10007160014,彰化縣,永靖鄉,永興村,345,77,308,299,37,-222,12.013,-74.247
10007160015,彰化縣,永靖鄉,崙子村,282,74,230,284,52,-210,22.609,-73.944
10007160001,彰化縣,永靖鄉,永東村,190,31,180,146,10,-115,5.556,-78.767
10007160002,彰化縣,永靖鄉,永西村,312,92,271,334,41,-242,15.129,-72.455
10007160003,彰化縣,永靖鄉,永南村,429,101,359,371,70,-270,19.499,-72.776
10007160004,彰化縣,永靖鄉,永北村,494,128,371,412,123,-284,33.154,-68.932
10007160005,彰化縣,永靖鄉,港西村,403,82,294,367,109,-285,37.075,-77.657
10007160006,彰化縣,永靖鄉,五福村,317,74,255,279,62,-205,24.314,-73.477
10007160007,彰化縣,永靖鄉,湳港村,203,69,118,262,85,-193,72.034,-73.664
10007160008,彰化縣,永靖鄉,新莊村,272,44,203,151,69,-107,33.99,-70.861
10007160009,彰化縣,永靖鄉,瑚璉村,607,133,470,504,137,-371,29.149,-73.611
10007160016,彰化縣,永靖鄉,獨鰲村,203,28,129,131,74,-103,57.364,-78.626
10007160017,彰化縣,永靖鄉,敦厚村,156,38,112,134,44,-96,39.286,-71.642
10007160018,彰化縣,永靖鄉,崙美村,168,54,111,194,57,-140,51.351,-72.165
10007160019,彰化縣,永靖鄉,同安村,128,34,105,148,23,-114,21.905,-77.027
10007160020,彰化縣,永靖鄉,同仁村,179,40,148,162,31,-122,20.946,-75.309
10007160021,彰化縣,永靖鄉,湳墘村,156,50,136,157,20,-107,14.706,-68.153
10007160022,彰化縣,永靖鄉,四芳村,133,34,130,111,3,-77,2.308,-69.369
10007160023,彰化縣,永靖鄉,福興村,238,53,188,168,50,-115,26.596,-68.452
10007160024,彰化縣,永靖鄉,竹子村,196,96,163,341,33,-245,20.245,-71.848
10007110001,彰化縣,溪湖鎮,光平里,233,83,215,273,18,-190,8.372,-69.597
10007110002,彰化縣,溪湖鎮,平和里,147,35,147,148,0,-113,0.0,-76.351
10007110003,彰化縣,溪湖鎮,太平里,410,100,344,300,66,-200,19.186,-66.667
10007110004,彰化縣,溪湖鎮,光華里,109,22,101,73,8,-51,7.921,-69.863
10007110018,彰化縣,溪湖鎮,湖東里,904,212,777,820,127,-608,16.345,-74.146
10007110014,彰化縣,溪湖鎮,中山里,466,73,389,367,77,-294,19.794,-80.109
10007110017,彰化縣,溪湖鎮,西溪里,388,83,336,366,52,-283,15.476,-77.322
10007110015,彰化縣,溪湖鎮,中竹里,163,27,124,176,39,-149,31.452,-84.659
10007110005,彰化縣,溪湖鎮,東寮里,791,159,643,548,148,-389,23.017,-70.985
10007110006,彰化縣,溪湖鎮,西寮里,528,97,441,400,87,-303,19.728,-75.75
10007110007,彰化縣,溪湖鎮,大突里,796,147,663,516,133,-369,20.06,-71.512
10007110008,彰化縣,溪湖鎮,北勢里,266,52,182,264,84,-212,46.154,-80.303
10007110009,彰化縣,溪湖鎮,汴頭里,571,128,465,527,106,-399,22.796,-75.712
10007110010,彰化縣,溪湖鎮,大竹里,543,135,469,434,74,-299,15.778,-68.894
10007110011,彰化縣,溪湖鎮,湖西里,499,101,425,400,74,-299,17.412,-74.75
10007110012,彰化縣,溪湖鎮,田中里,153,44,114,172,39,-128,34.211,-74.419
10007110013,彰化縣,溪湖鎮,河東里,360,78,279,331,81,-253,29.032,-76.435
10007110019,彰化縣,溪湖鎮,頂庄里,133,30,104,102,29,-72,27.885,-70.588
10007110020,彰化縣,溪湖鎮,忠覺里,241,51,256,218,-15,-167,-5.859,-76.606
10007110021,彰化縣,溪湖鎮,湳底里,151,31,110,126,41,-95,37.273,-75.397
10007110022,彰化縣,溪湖鎮,大庭里,290,55,234,210,56,-155,23.932,-73.81
10007110023,彰化縣,溪湖鎮,媽厝里,171,53,145,241,26,-188,17.931,-78.008
10007110025,彰化縣,溪湖鎮,番婆里,320,72,253,313,67,-241,26.482,-76.997
10007110024,彰化縣,溪湖鎮,西勢里,338,69,296,412,42,-343,14.189,-83.252
10007110016,彰化縣,溪湖鎮,東溪里,229,62,174,284,55,-222,31.609,-78.169
10007140001,彰化縣,埔鹽鄉,埔鹽村,418,76,350,318,68,-242,19.429,-76.101
10007140002,彰化縣,埔鹽鄉,埔南村,327,63,280,269,47,-206,16.786,-76.58
10007140003,彰化縣,埔鹽鄉,廍子村,324,54,257,195,67,-141,26.07,-72.308
10007140004,彰化縣,埔鹽鄉,出水村,237,33,191,143,46,-110,24.084,-76.923
10007140005,彰化縣,埔鹽鄉,南港村,433,72,326,282,107,-210,32.822,-74.468
10007140006,彰化縣,埔鹽鄉,打廉村,189,45,152,177,37,-132,24.342,-74.576
10007140007,彰化縣,埔鹽鄉,豐澤村,258,48,213,237,45,-189,21.127,-79.747
10007140008,彰化縣,埔鹽鄉,崑崙村,260,53,194,190,66,-137,34.021,-72.105
10007140009,彰化縣,埔鹽鄉,角樹村,172,13,161,112,11,-99,6.832,-88.393
10007140010,彰化縣,埔鹽鄉,瓦磘村,254,39,208,212,46,-173,22.115,-81.604
10007140011,彰化縣,埔鹽鄉,好修村,409,78,305,250,104,-172,34.098,-68.8
10007140012,彰化縣,埔鹽鄉,西湖村,436,51,340,300,96,-249,28.235,-83.0
10007140013,彰化縣,埔鹽鄉,大有村,234,50,183,211,51,-161,27.869,-76.303
10007140014,彰化縣,埔鹽鄉,新興村,110,15,113,72,-3,-57,-2.655,-79.167
10007140015,彰化縣,埔鹽鄉,永平村,232,45,210,165,22,-120,10.476,-72.727
10007140016,彰化縣,埔鹽鄉,永樂村,188,52,155,153,33,-101,21.29,-66.013
10007140017,彰化縣,埔鹽鄉,石埤村,264,43,183,209,81,-166,44.262,-79.426
10007140018,彰化縣,埔鹽鄉,天盛村,169,26,154,101,15,-75,9.74,-74.257
10007140019,彰化縣,埔鹽鄉,太平村,292,38,261,211,31,-173,11.877,-81.991
10007140020,彰化縣,埔鹽鄉,新水村,349,35,339,168,10,-133,2.95,-79.167
10007140021,彰化縣,埔鹽鄉,三省村,305,61,243,206,62,-145,25.514,-70.388
10007140022,彰化縣,埔鹽鄉,南新村,312,38,284,164,28,-126,9.859,-76.829
10007150001,彰化縣,埔心鄉,東門村,766,191,619,744,147,-553,23.748,-74.328
10007150002,彰化縣,埔心鄉,埔心村,224,87,184,278,40,-191,21.739,-68.705
10007150003,彰化縣,埔心鄉,義民村,370,107,310,305,60,-198,19.355,-64.918
10007150004,彰化縣,埔心鄉,油車村,256,64,224,223,32,-159,14.286,-71.3
10007150005,彰化縣,埔心鄉,瓦北村,376,121,259,399,117,-278,45.174,-69.674
10007150006,彰化縣,埔心鄉,瓦中村,478,112,329,437,149,-325,45.289,-74.371
10007150007,彰化縣,埔心鄉,瓦南村,294,88,229,331,65,-243,28.384,-73.414
10007150009,彰化縣,埔心鄉,經口村,496,134,373,512,123,-378,32.976,-73.828
10007150008,彰化縣,埔心鄉,太平村,421,87,298,360,123,-273,41.275,-75.833
10007150010,彰化縣,埔心鄉,大華村,135,35,95,132,40,-97,42.105,-73.485
10007150011,彰化縣,埔心鄉,仁里村,232,61,195,240,37,-179,18.974,-74.583
10007150012,彰化縣,埔心鄉,舊舘村,302,72,248,326,54,-254,21.774,-77.914
10007150013,彰化縣,埔心鄉,南舘村,186,52,145,218,41,-166,28.276,-76.147
10007150014,彰化縣,埔心鄉,新舘村,225,43,159,178,66,-135,41.509,-75.843
10007150016,彰化縣,埔心鄉,芎蕉村,400,104,256,408,144,-304,56.25,-74.51
10007150015,彰化縣,埔心鄉,羅厝村,178,83,154,279,24,-196,15.584,-70.251
10007150018,彰化縣,埔心鄉,梧鳳村,133,41,135,182,-2,-141,-1.481,-77.473
10007150017,彰化縣,埔心鄉,二重村,246,82,212,309,34,-227,16.038,-73.463
10007150019,彰化縣,埔心鄉,埤霞村,149,41,116,135,33,-94,28.448,-69.63
10007150020,彰化縣,埔心鄉,埤脚村,216,30,173,146,43,-116,24.855,-79.452
10007120001,彰化縣,田中鎮,香山里,134,41,123,146,11,-105,8.943,-71.918
10007120002,彰化縣,田中鎮,碧峰里,230,42,217,149,13,-107,5.991,-71.812
10007120003,彰化縣,田中鎮,東源里,181,42,138,139,43,-97,31.159,-69.784
10007120004,彰化縣,田中鎮,復興里,330,46,288,245,42,-199,14.583,-81.224
10007120005,彰化縣,田中鎮,平和里,294,64,283,239,11,-175,3.887,-73.222
10007120006,彰化縣,田中鎮,頂潭里,212,82,212,251,0,-169,0.0,-67.331
10007120014,彰化縣,田中鎮,新庄里,571,125,461,476,110,-351,23.861,-73.739
10007120007,彰化縣,田中鎮,中潭里,354,98,279,365,75,-267,26.882,-73.151
10007120008,彰化縣,田中鎮,龍潭里,126,38,103,151,23,-113,22.33,-74.834
10007120009,彰化縣,田中鎮,北路里,731,149,684,620,47,-471,6.871,-75.968
10007120010,彰化縣,田中鎮,西路里,514,119,430,496,84,-377,19.535,-76.008
10007120011,彰化縣,田中鎮,東路里,219,61,182,222,37,-161,20.33,-72.523
10007120012,彰化縣,田中鎮,南路里,212,63,190,261,22,-198,11.579,-75.862
10007120013,彰化縣,田中鎮,中路里,415,99,408,398,7,-299,1.716,-75.126
10007120019,彰化縣,田中鎮,梅州里,191,79,189,243,2,-164,1.058,-67.49
10007120015,彰化縣,田中鎮,三安里,271,84,204,368,67,-284,32.843,-77.174
10007120016,彰化縣,田中鎮,大崙里,226,41,209,234,17,-193,8.134,-82.479
10007120017,彰化縣,田中鎮,沙崙里,369,72,325,303,44,-231,13.538,-76.238
10007120018,彰化縣,田中鎮,新民里,895,233,743,785,152,-552,20.458,-70.318
10007120020,彰化縣,田中鎮,三民里,366,64,263,251,103,-187,39.163,-74.502
10007120021,彰化縣,田中鎮,三光里,149,33,137,187,12,-154,8.759,-82.353
10007120022,彰化縣,田中鎮,大社里,175,39,129,197,46,-158,35.659,-80.203
10007170001,彰化縣,社頭鄉,社頭村,490,148,421,618,69,-470,16.39,-76.052
10007170004,彰化縣,社頭鄉,廣興村,754,233,648,927,106,-694,16.358,-74.865
10007170002,彰化縣,社頭鄉,東興村,317,62,244,260,73,-198,29.918,-76.154
10007170022,彰化縣,社頭鄉,松竹村,220,65,155,225,65,-160,41.935,-71.111
10007170019,彰化縣,社頭鄉,舊社村,297,102,267,360,30,-258,11.236,-71.667
10007170005,彰化縣,社頭鄉,廣福村,198,73,138,205,60,-132,43.478,-64.39
10007170008,彰化縣,社頭鄉,橋頭村,362,90,328,433,34,-343,10.366,-79.215
10007170014,彰化縣,社頭鄉,新厝村,288,83,240,305,48,-222,20.0,-72.787
10007170017,彰化縣,社頭鄉,張厝村,238,56,207,251,31,-195,14.976,-77.689
10007170011,彰化縣,社頭鄉,湳底村,329,112,227,338,102,-226,44.934,-66.864
10007170007,彰化縣,社頭鄉,仁雅村,633,149,500,542,133,-393,26.6,-72.509
10007170016,彰化縣,社頭鄉,里仁村,238,55,187,189,51,-134,27.273,-70.899
10007170013,彰化縣,社頭鄉,美雅村,279,63,207,252,72,-189,34.783,-75.0
10007170010,彰化縣,社頭鄉,崙雅村,213,42,162,173,51,-131,31.481,-75.723
10007170023,彰化縣,社頭鄉,清水村,254,67,223,195,31,-128,13.901,-65.641
10007170003,彰化縣,社頭鄉,山湖村,195,76,154,272,41,-196,26.623,-72.059
10007170020,彰化縣,社頭鄉,埤斗村,160,62,125,212,35,-150,28.0,-70.755
10007170009,彰化縣,社頭鄉,仁和村,166,40,119,115,47,-75,39.496,-65.217
10007170015,彰化縣,社頭鄉,平和村,186,47,167,193,19,-146,11.377,-75.648
10007170024,彰化縣,社頭鄉,協和村,396,106,308,432,88,-326,28.571,-75.463
10007170012,彰化縣,社頭鄉,泰安村,179,46,156,142,23,-96,14.744,-67.606
10007170006,彰化縣,社頭鄉,朝興村,169,60,193,231,-24,-171,-12.435,-74.026
10007170018,彰化縣,社頭鄉,龍井村,131,39,103,168,28,-129,27.184,-76.786
10007170021,彰化縣,社頭鄉,湳雅村,265,77,201,311,64,-234,31.841,-75.241
10007180016,彰化縣,二水鄉,復興村,163,61,152,223,11,-162,7.237,-72.646
10007180017,彰化縣,二水鄉,十五村,102,46,111,155,-9,-109,-8.108,-70.323
10007180001,彰化縣,二水鄉,合和村,161,21,143,168,18,-147,12.587,-87.5
10007180002,彰化縣,二水鄉,上豊村,179,48,148,223,31,-175,20.946,-78.475
10007180003,彰化縣,二水鄉,過圳村,133,49,115,123,18,-74,15.652,-60.163
10007180004,彰化縣,二水鄉,五伯村,151,43,122,132,29,-89,23.77,-67.424
10007180006,彰化縣,二水鄉,文化村,182,36,185,178,-3,-142,-1.622,-79.775
10007180005,彰化縣,二水鄉,光化村,196,58,177,201,19,-143,10.734,-71.144
10007180008,彰化縣,二水鄉,聖化村,123,22,117,77,6,-55,5.128,-71.429
10007180007,彰化縣,二水鄉,二水村,151,62,143,174,8,-112,5.594,-64.368
10007180010,彰化縣,二水鄉,惠民村,125,66,142,194,-17,-128,-11.972,-65.979
10007180009,彰化縣,二水鄉,裕民村,173,55,171,198,2,-143,1.17,-72.222
10007180011,彰化縣,二水鄉,大園村,128,52,94,171,34,-119,36.17,-69.591
10007180012,彰化縣,二水鄉,修仁村,146,39,153,135,-7,-96,-4.575,-71.111
10007180013,彰化縣,二水鄉,合興村,112,35,102,162,10,-127,9.804,-78.395
10007180014,彰化縣,二水鄉,源泉村,126,20,117,116,9,-96,7.692,-82.759
10007180015,彰化縣,二水鄉,倡和村,87,29,110,108,-23,-79,-20.909,-73.148
10007190012,彰化縣,北斗鎮,中寮里,524,181,404,545,120,-364,29.703,-66.789
10007190013,彰化縣,北斗鎮,大道里,395,104,278,426,117,-322,42.086,-75.587
10007190010,彰化縣,北斗鎮,西德里,988,237,822,918,166,-681,20.195,-74.183
10007190011,彰化縣,北斗鎮,西安里,337,50,279,272,58,-222,20.789,-81.618
10007190001,彰化縣,北斗鎮,光復里,449,91,325,359,124,-268,38.154,-74.652
10007190002,彰化縣,北斗鎮,新政里,158,43,156,144,2,-101,1.282,-70.139
10007190003,彰化縣,北斗鎮,重慶里,80,50,80,147,0,-97,0.0,-65.986
10007190004,彰化縣,北斗鎮,五權里,133,53,126,152,7,-99,5.556,-65.132
10007190005,彰化縣,北斗鎮,七星里,263,106,217,304,46,-198,21.198,-65.132
10007190006,彰化縣,北斗鎮,居仁里,353,66,313,223,40,-157,12.78,-70.404
10007190007,彰化縣,北斗鎮,東光里,490,141,362,467,128,-326,35.359,-69.807
10007190008,彰化縣,北斗鎮,文昌里,724,176,548,573,176,-397,32.117,-69.284
10007190009,彰化縣,北斗鎮,中和里,241,49,184,227,57,-178,30.978,-78.414
10007190014,彰化縣,北斗鎮,新生里,383,76,293,298,90,-222,30.717,-74.497
10007190015,彰化縣,北斗鎮,大新里,367,54,308,281,59,-227,19.156,-80.783
10007210001,彰化縣,田尾鄉,田尾村,255,63,233,257,22,-194,9.442,-75.486
10007210012,彰化縣,田尾鄉,溪畔村,258,73,192,248,66,-175,34.375,-70.565
10007210013,彰化縣,田尾鄉,打簾村,363,93,307,361,56,-268,18.241,-74.238
10007210020,彰化縣,田尾鄉,正義村,169,58,166,178,3,-120,1.807,-67.416
10007210011,彰化縣,田尾鄉,北曾村,306,95,232,347,74,-252,31.897,-72.622
10007210010,彰化縣,田尾鄉,南曾村,254,88,185,272,69,-184,37.297,-67.647
10007210003,彰化縣,田尾鄉,饒平村,622,121,503,454,119,-333,23.658,-73.348
10007210002,彰化縣,田尾鄉,豐田村,171,34,139,130,32,-96,23.022,-73.846
10007210017,彰化縣,田尾鄉,仁里村,328,81,256,292,72,-211,28.125,-72.26
10007210018,彰化縣,田尾鄉,新厝村,41,6,41,52,0,-46,0.0,-88.462
10007210019,彰化縣,田尾鄉,溪頂村,125,44,90,134,35,-90,38.889,-67.164
10007210014,彰化縣,田尾鄉,柳鳳村,232,46,213,204,19,-158,8.92,-77.451
10007210015,彰化縣,田尾鄉,陸豐村,171,27,140,157,31,-130,22.143,-82.803
10007210016,彰化縣,田尾鄉,海豐村,223,70,203,252,20,-182,9.852,-72.222
10007210004,彰化縣,田尾鄉,睦宜村,214,44,159,199,55,-155,34.591,-77.889
10007210009,彰化縣,田尾鄉,新生村,260,66,198,281,62,-215,31.313,-76.512
10007210007,彰化縣,田尾鄉,北鎮村,226,57,182,190,44,-133,24.176,-70.0
10007210008,彰化縣,田尾鄉,南鎮村,101,31,89,138,12,-107,13.483,-77.536
10007210005,彰化縣,田尾鄉,福田村,170,37,125,156,45,-119,36.0,-76.282
10007210006,彰化縣,田尾鄉,新興村,236,84,173,242,63,-158,36.416,-65.289
10007220001,彰化縣,埤頭鄉,和豊村,458,99,356,412,102,-313,28.652,-75.971
10007220002,彰化縣,埤頭鄉,興農村,325,78,271,307,54,-229,19.926,-74.593
10007220003,彰化縣,埤頭鄉,埤頭村,259,92,233,347,26,-255,11.159,-73.487
10007220004,彰化縣,埤頭鄉,豊崙村,387,59,381,260,6,-201,1.575,-77.308
10007220005,彰化縣,埤頭鄉,崙子村,215,55,199,212,16,-157,8.04,-74.057
10007220018,彰化縣,埤頭鄉,永豐村,263,51,,,,,,
10007220007,彰化縣,埤頭鄉,合興村,699,138,641,535,58,-397,9.048,-74.206
10007220008,彰化縣,埤頭鄉,平原村,477,67,343,328,134,-261,39.067,-79.573
10007220009,彰化縣,埤頭鄉,崙腳村,128,39,92,141,36,-102,39.13,-72.34
10007220010,彰化縣,埤頭鄉,元埔村,115,19,87,119,28,-100,32.184,-84.034
10007220011,彰化縣,埤頭鄉,芙朝村,265,62,255,236,10,-174,3.922,-73.729
10007220012,彰化縣,埤頭鄉,新庄村,144,57,102,235,42,-178,41.176,-75.745
10007220013,彰化縣,埤頭鄉,陸嘉村,153,44,91,155,62,-111,68.132,-71.613
10007220014,彰化縣,埤頭鄉,竹圍村,173,45,129,226,44,-181,34.109,-80.088
10007220015,彰化縣,埤頭鄉,中和村,252,76,209,300,43,-224,20.574,-74.667
10007220016,彰化縣,埤頭鄉,庄內村,145,46,114,217,31,-171,27.193,-78.802
10007220017,彰化縣,埤頭鄉,大湖村,149,52,114,225,35,-173,30.702,-76.889
10007260001,彰化縣,溪州鄉,溪厝村,286,77,237,361,49,-284,20.675,-78.67
10007260005,彰化縣,溪州鄉,坑厝村,137,41,86,160,51,-119,59.302,-74.375
10007260008,彰化縣,溪州鄉,瓦厝村,156,63,121,243,35,-180,28.926,-74.074
10007260011,彰化縣,溪州鄉,溪州村,313,99,261,323,52,-224,19.923,-69.35
10007260014,彰化縣,溪州鄉,尾厝村,372,80,298,365,74,-285,24.832,-78.082
10007260017,彰化縣,溪州鄉,東州村,340,113,297,419,43,-306,14.478,-73.031
10007260002,彰化縣,溪州鄉,舊眉村,240,71,197,296,43,-225,21.827,-76.014
10007260006,彰化縣,溪州鄉,圳寮村,219,36,197,267,22,-231,11.168,-86.517
10007260009,彰化縣,溪州鄉,西畔村,256,84,212,362,44,-278,20.755,-76.796
10007260003,彰化縣,溪州鄉,柑園村,184,43,154,144,30,-101,19.481,-70.139
10007260012,彰化縣,溪州鄉,成功村,251,87,211,299,40,-212,18.957,-70.903
10007260015,彰化縣,溪州鄉,大庄村,218,95,169,377,49,-282,28.994,-74.801
10007260018,彰化縣,溪州鄉,榮光村,164,36,147,135,17,-99,11.565,-73.333
10007260007,彰化縣,溪州鄉,潮洋村,121,28,109,141,12,-113,11.009,-80.142
10007260010,彰化縣,溪州鄉,張厝村,107,25,65,129,42,-104,64.615,-80.62
10007260013,彰化縣,溪州鄉,菜公村,136,50,98,154,38,-104,38.776,-67.532
10007260019,彰化縣,溪州鄉,三條村,88,58,67,261,21,-203,31.343,-77.778
10007260016,彰化縣,溪州鄉,三圳村,227,69,179,257,48,-188,26.816,-73.152
10007260004,彰化縣,溪州鄉,水尾村,173,87,121,369,52,-282,42.975,-76.423
10007200012,彰化縣,二林鎮,豐田里,406,86,379,364,27,-278,7.124,-76.374
10007200001,彰化縣,二林鎮,東和里,378,92,311,364,67,-272,21.543,-74.725
10007200002,彰化縣,二林鎮,南光里,690,117,636,477,54,-360,8.491,-75.472
10007200003,彰化縣,二林鎮,西平里,327,68,250,235,77,-167,30.8,-71.064
10007200004,彰化縣,二林鎮,北平里,589,169,437,512,152,-343,34.783,-66.992
10007200005,彰化縣,二林鎮,中西里,264,43,266,174,-2,-131,-0.752,-75.287
10007200006,彰化縣,二林鎮,廣興里,181,43,197,185,-16,-142,-8.122,-76.757
10007200007,彰化縣,二林鎮,香田里,140,43,129,171,11,-128,8.527,-74.854
10007200008,彰化縣,二林鎮,外竹里,170,9,147,124,23,-115,15.646,-92.742
10007200009,彰化縣,二林鎮,興華里,251,42,223,167,28,-125,12.556,-74.85
10007200010,彰化縣,二林鎮,東興里,325,89,281,237,44,-148,15.658,-62.447
10007200011,彰化縣,二林鎮,後厝里,808,166,631,487,177,-321,28.051,-65.914
10007200013,彰化縣,二林鎮,頂厝里,184,41,196,166,-12,-125,-6.122,-75.301
10007200014,彰化縣,二林鎮,趙甲里,298,61,254,213,44,-152,17.323,-71.362
10007200015,彰化縣,二林鎮,振興里,219,29,168,163,51,-134,30.357,-82.209
10007200016,彰化縣,二林鎮,萬興里,136,25,138,122,-2,-97,-1.449,-79.508
10007200017,彰化縣,二林鎮,永興里,275,50,255,249,20,-199,7.843,-79.92
10007200018,彰化縣,二林鎮,西庄里,219,64,152,200,67,-136,44.079,-68.0
10007200019,彰化縣,二林鎮,梅芳里,175,20,171,163,4,-143,2.339,-87.73
10007200020,彰化縣,二林鎮,華崙里,710,111,668,451,42,-340,6.287,-75.388
10007200022,彰化縣,二林鎮,萬合里,188,22,170,118,18,-96,10.588,-81.356
10007200021,彰化縣,二林鎮,東勢里,145,20,146,151,-1,-131,-0.685,-86.755
10007200023,彰化縣,二林鎮,大永里,158,39,120,127,38,-88,31.667,-69.291
10007200024,彰化縣,二林鎮,原斗里,202,72,233,251,-31,-179,-13.305,-71.315
10007200025,彰化縣,二林鎮,西斗里,220,35,172,165,48,-130,27.907,-78.788
10007200026,彰化縣,二林鎮,東華里,144,58,144,217,0,-159,0.0,-73.272
10007200027,彰化縣,二林鎮,復豐里,108,35,91,111,17,-76,18.681,-68.468
10007240007,彰化縣,大城鄉,山腳村,150,43,160,154,-10,-111,-6.25,-72.078
10007240001,彰化縣,大城鄉,潭墘村,135,54,127,186,8,-132,6.299,-70.968
10007240005,彰化縣,大城鄉,大城村,197,21,189,148,8,-127,4.233,-85.811
10007240003,彰化縣,大城鄉,東城村,202,36,204,173,-2,-137,-0.98,-79.191
10007240004,彰化縣,大城鄉,西城村,132,17,124,97,8,-80,6.452,-82.474
10007240002,彰化縣,大城鄉,上山村,181,31,183,131,-2,-100,-1.093,-76.336
10007240008,彰化縣,大城鄉,永和村,78,12,94,70,-16,-58,-17.021,-82.857
10007240010,彰化縣,大城鄉,公館村,143,31,181,122,-38,-91,-20.994,-74.59
10007240014,彰化縣,大城鄉,豐美村,114,18,86,129,28,-111,32.558,-86.047
10007240015,彰化縣,大城鄉,三豐村,61,14,63,47,-2,-33,-3.175,-70.213
10007240006,彰化縣,大城鄉,菜寮村,146,23,139,88,7,-65,5.036,-73.864
10007240012,彰化縣,大城鄉,東港村,191,27,168,106,23,-79,13.69,-74.528
10007240013,彰化縣,大城鄉,西港村,158,13,152,87,6,-74,3.947,-85.057
10007240009,彰化縣,大城鄉,頂庄村,92,27,92,90,0,-63,0.0,-70.0
10007240011,彰化縣,大城鄉,臺西村,97,16,114,108,-17,-92,-14.912,-85.185
10007230001,彰化縣,芳苑鄉,芳苑村,98,38,84,164,14,-126,16.667,-76.829
10007230002,彰化縣,芳苑鄉,芳中村,58,29,65,81,-7,-52,-10.769,-64.198
10007230003,彰化縣,芳苑鄉,仁愛村,130,25,116,105,14,-80,12.069,-76.19
10007230004,彰化縣,芳苑鄉,信義村,64,14,58,75,6,-61,10.345,-81.333
10007230005,彰化縣,芳苑鄉,後寮村,157,31,122,107,35,-76,28.689,-71.028
10007230006,彰化縣,芳苑鄉,三合村,415,107,296,375,119,-268,40.203,-71.467
10007230007,彰化縣,芳苑鄉,永興村,213,30,200,207,13,-177,6.5,-85.507
10007230014,彰化縣,芳苑鄉,新街村,89,25,68,128,21,-103,30.882,-80.469
10007230009,彰化縣,芳苑鄉,路上村,97,32,88,87,9,-55,10.227,-63.218
10007230010,彰化縣,芳苑鄉,路平村,180,26,127,92,53,-66,41.732,-71.739
10007230011,彰化縣,芳苑鄉,三成村,139,31,100,126,39,-95,39.0,-75.397
10007230012,彰化縣,芳苑鄉,福榮村,89,13,77,104,12,-91,15.584,-87.5
10007230013,彰化縣,芳苑鄉,頂廍村,72,14,74,98,-2,-84,-2.703,-85.714
10007230015,彰化縣,芳苑鄉,王功村,240,96,193,446,47,-350,24.352,-78.475
10007230016,彰化縣,芳苑鄉,博愛村,99,68,65,180,34,-112,52.308,-62.222
10007230017,彰化縣,芳苑鄉,和平村,82,36,88,123,-6,-87,-6.818,-70.732
10007230019,彰化縣,芳苑鄉,興仁村,155,72,115,260,40,-188,34.783,-72.308
10007230018,彰化縣,芳苑鄉,民生村,74,23,68,145,6,-122,8.824,-84.138
10007230020,彰化縣,芳苑鄉,新寶村,211,58,179,309,32,-251,17.877,-81.23
10007230008,彰化縣,芳苑鄉,五俊村,87,13,47,56,40,-43,85.106,-76.786
10007230021,彰化縣,芳苑鄉,草湖村,299,39,219,231,80,-192,36.53,-83.117
10007230023,彰化縣,芳苑鄉,建平村,362,73,259,330,103,-257,39.768,-77.879
10007230024,彰化縣,芳苑鄉,崙腳村,123,13,109,105,14,-92,12.844,-87.619
10007230022,彰化縣,芳苑鄉,文津村,139,17,114,121,25,-104,21.93,-85.95
10007230025,彰化縣,芳苑鄉,新生村,234,42,142,186,92,-144,64.789,-77.419
10007230026,彰化縣,芳苑鄉,漢寶村,546,110,430,525,116,-415,26.977,-79.048
10007250001,彰化縣,竹塘鄉,竹元村,209,55,195,189,14,-134,7.179,-70.899
10007250002,彰化縣,竹塘鄉,竹塘村,332,88,339,307,-7,-219,-2.065,-71.336
10007250003,彰化縣,竹塘鄉,小西村,120,27,113,115,7,-88,6.195,-76.522
10007250004,彰化縣,竹塘鄉,民靖村,113,27,119,101,-6,-74,-5.042,-73.267
10007250005,彰化縣,竹塘鄉,五庄村,185,76,147,316,38,-240,25.85,-75.949
10007250006,彰化縣,竹塘鄉,樹腳村,51,48,69,138,-18,-90,-26.087,-65.217
10007250007,彰化縣,竹塘鄉,田頭村,135,34,145,181,-10,-147,-6.897,-81.215
10007250008,彰化縣,竹塘鄉,新廣村,164,50,136,213,28,-163,20.588,-76.526
10007250009,彰化縣,竹塘鄉,溪墘村,74,21,63,109,11,-88,17.46,-80.734
10007250010,彰化縣,竹塘鄉,竹林村,102,28,108,129,-6,-101,-5.556,-78.295
10007250011,彰化縣,竹塘鄉,土庫村,86,21,91,127,-5,-106,-5.495,-83.465
10007250012,彰化縣,竹塘鄉,內新村,67,29,51,135,16,-106,31.373,-78.519
10007250013,彰化縣,竹塘鄉,長安村,89,18,80,168,9,-150,11.25,-89.286
10007250014,彰化縣,竹塘鄉,永安村,63,21,43,102,20,-81,46.512,-79.412
10020010044,嘉義市,東區,短竹里,571,192,539,544,32,-352,5.937,-64.706
10020010065,嘉義市,東區,蘭潭里,502,160,438,473,64,-313,14.612,-66.173
10020010038,嘉義市,東區,東川里,385,125,428,375,-43,-250,-10.047,-66.667
10020010042,嘉義市,東區,鹿寮里,185,77,160,220,25,-143,15.625,-65.0
10020010041,嘉義市,東區,盧厝里,395,151,370,433,25,-282,6.757,-65.127
10020010066,嘉義市,東區,文雅里,772,275,819,803,-47,-528,-5.739,-65.753
10020010037,嘉義市,東區,王田里,488,182,511,546,-23,-364,-4.501,-66.667
10020010043,嘉義市,東區,長竹里,608,214,607,689,1,-475,0.165,-68.94
10020010036,嘉義市,東區,後庄里,948,286,855,840,93,-554,10.877,-65.952
10020010035,嘉義市,東區,新店里,893,295,920,926,-27,-631,-2.935,-68.143
10020010034,嘉義市,東區,圳頭里,978,284,961,809,17,-525,1.769,-64.895
10020010061,嘉義市,東區,中山里,430,160,446,456,-16,-296,-3.587,-64.912
10020010039,嘉義市,東區,太平里,914,314,883,901,31,-587,3.511,-65.15
10020010060,嘉義市,東區,東興里,333,190,353,498,-20,-308,-5.666,-61.847
10020010059,嘉義市,東區,華南里,334,143,324,478,10,-335,3.086,-70.084
10020010062,嘉義市,東區,中央里,353,241,360,634,-7,-393,-1.944,-61.987
10020010058,嘉義市,東區,朝陽里,314,169,330,513,-16,-344,-4.848,-67.057
10020010057,嘉義市,東區,民族里,239,120,278,387,-39,-267,-14.029,-68.992
10020010056,嘉義市,東區,過溝里,324,158,371,534,-47,-376,-12.668,-70.412
10020010045,嘉義市,東區,新開里,380,185,397,453,-17,-268,-4.282,-59.161
10020010046,嘉義市,東區,宣信里,209,93,195,299,14,-206,7.179,-68.896
10020010047,嘉義市,東區,興南里,269,150,222,410,47,-260,21.171,-63.415
10020010048,嘉義市,東區,豐年里,190,95,199,319,-9,-224,-4.523,-70.219
10020010049,嘉義市,東區,芳草里,668,232,581,717,87,-485,14.974,-67.643
10020010050,嘉義市,東區,芳安里,433,190,423,524,10,-334,2.364,-63.74
10020010051,嘉義市,東區,頂寮里,459,238,433,630,26,-392,6.005,-62.222
10020010052,嘉義市,東區,安寮里,537,233,481,647,56,-414,11.642,-63.988
10020010067,嘉義市,東區,安業里,426,128,368,409,58,-281,15.761,-68.704
10020010054,嘉義市,東區,興村里,824,272,701,824,123,-552,17.546,-66.99
10020010053,嘉義市,東區,興安里,715,219,523,636,192,-417,36.711,-65.566
10020010055,嘉義市,東區,興仁里,723,300,711,806,12,-506,1.688,-62.779
10020010064,嘉義市,東區,北門里,385,169,368,584,17,-415,4.62,-71.062
10020010063,嘉義市,東區,林森里,427,184,404,567,23,-383,5.693,-67.549
10020010004,嘉義市,東區,中庄里,643,288,610,705,33,-417,5.41,-59.149
10020010005,嘉義市,東區,頂庄里,454,151,435,469,19,-318,4.368,-67.804
10020010068,嘉義市,東區,義教里,449,197,452,590,-3,-393,-0.664,-66.61
10020010003,嘉義市,東區,仁義里,603,229,537,645,66,-416,12.291,-64.496
10020010002,嘉義市,東區,後湖里,765,261,595,774,170,-513,28.571,-66.279
10020010001,嘉義市,東區,荖藤里,914,321,712,1039,202,-718,28.371,-69.105
10020020031,嘉義市,西區,書院里,387,171,366,503,21,-332,5.738,-66.004
10020020056,嘉義市,西區,永和里,329,145,324,449,5,-304,1.543,-67.706
10020020057,嘉義市,西區,新富里,245,192,247,490,-2,-298,-0.81,-60.816
10020020058,嘉義市,西區,文化里,404,215,393,634,11,-419,2.799,-66.088
10020020059,嘉義市,西區,西榮里,339,234,365,638,-26,-404,-7.123,-63.323
10020020061,嘉義市,西區,番社里,233,144,229,411,4,-267,1.747,-64.964
10020020060,嘉義市,西區,國華里,252,103,230,318,22,-215,9.565,-67.61
10020020015,嘉義市,西區,大溪里,345,125,270,551,75,-426,27.778,-77.314
10020020018,嘉義市,西區,磚磘里,570,249,551,843,19,-594,3.448,-70.463
10020020016,嘉義市,西區,福全里,779,286,683,928,96,-642,14.056,-69.181
10020020065,嘉義市,西區,福安里,821,368,691,1013,130,-645,18.813,-63.672
10020020022,嘉義市,西區,新西里,328,152,331,464,-3,-312,-0.906,-67.241
10020020019,嘉義市,西區,港坪里,663,224,582,773,81,-549,13.918,-71.022
10020020020,嘉義市,西區,頭港里,364,143,291,460,73,-317,25.086,-68.913
10020020017,嘉義市,西區,西平里,628,258,535,801,93,-543,17.383,-67.79
10020020021,嘉義市,西區,劉厝里,1496,436,1222,1428,274,-992,22.422,-69.468
10020020055,嘉義市,西區,自強里,310,129,305,393,5,-264,1.639,-67.176
10020020050,嘉義市,西區,美源里,661,304,659,873,2,-569,0.303,-65.178
10020020049,嘉義市,西區,湖內里,1048,412,655,1111,393,-699,60.0,-62.916
10020020066,嘉義市,西區,獅子里,554,190,498,644,56,-454,11.245,-70.497
10020020067,嘉義市,西區,紅瓦里,254,115,237,408,17,-293,7.173,-71.814
10020020053,嘉義市,西區,光路里,1107,391,986,1167,121,-776,12.272,-66.495
10020020048,嘉義市,西區,福民里,983,352,830,1294,153,-942,18.434,-72.798
10020020047,嘉義市,西區,車店里,1017,379,992,1347,25,-968,2.52,-71.863
10020020046,嘉義市,西區,垂楊里,316,125,276,408,40,-283,14.493,-69.363
10020020045,嘉義市,西區,培元里,386,81,442,331,-56,-250,-12.67,-75.529
10020020051,嘉義市,西區,育英里,346,156,307,468,39,-312,12.704,-66.667
10020020052,嘉義市,西區,致遠里,582,88,601,216,-19,-128,-3.161,-59.259
10020020054,嘉義市,西區,翠岱里,492,57,494,158,-2,-101,-0.405,-63.924
10020020062,嘉義市,西區,導明里,279,139,269,418,10,-279,3.717,-66.746
10020020003,嘉義市,西區,北榮里,392,193,382,636,10,-443,2.618,-69.654
10020020063,嘉義市,西區,慶安里,235,156,232,402,3,-246,1.293,-61.194
10020020001,嘉義市,西區,香湖里,134,54,123,179,11,-125,8.943,-69.832
10020020005,嘉義市,西區,重興里,334,156,289,472,45,-316,15.571,-66.949
10020020064,嘉義市,西區,後驛里,295,173,282,525,13,-352,4.61,-67.048
10020020002,嘉義市,西區,湖邊里,317,183,271,533,46,-350,16.974,-65.666
10020020009,嘉義市,西區,竹圍里,831,332,706,1026,125,-694,17.705,-67.641
10020020069,嘉義市,西區,保生里,837,406,717,1119,120,-713,16.736,-63.718
10020020011,嘉義市,西區,保安里,651,256,542,757,109,-501,20.111,-66.182
10020020070,嘉義市,西區,北新里,216,86,180,329,36,-243,20.0,-73.86
10020020010,嘉義市,西區,新厝里,726,400,574,1166,152,-766,26.481,-65.695
10020020068,嘉義市,西區,保福里,701,226,591,775,110,-549,18.613,-70.839
10020020014,嘉義市,西區,竹村里,198,71,176,248,22,-177,12.5,-71.371
10020020012,嘉義市,西區,北湖里,553,236,447,730,106,-494,23.714,-67.671
10020020013,嘉義市,西區,下埤里,297,117,228,365,69,-248,30.263,-67.945
10008030001,南投縣,草屯鎮,玉峰里,764,308,499,403,265,-95,53.106,-23.573
10008030026,南投縣,草屯鎮,明正里,1305,467,832,726,473,-259,56.851,-35.675
10008030002,南投縣,草屯鎮,炎峰里,700,303,484,438,216,-135,44.628,-30.822
10008030024,南投縣,草屯鎮,中正里,221,79,161,148,60,-69,37.267,-46.622
10008030003,南投縣,草屯鎮,和平里,331,184,244,261,87,-77,35.656,-29.502
10008030025,南投縣,草屯鎮,中山里,857,387,527,567,330,-180,62.619,-31.746
10008030004,南投縣,草屯鎮,敦和里,2293,814,1342,1153,951,-339,70.864,-29.402
10008030005,南投縣,草屯鎮,山腳里,3049,1057,1975,1370,1074,-313,54.38,-22.847
10008030027,南投縣,草屯鎮,新厝里,1214,444,833,596,381,-152,45.738,-25.503
10008030012,南投縣,草屯鎮,上林里,1245,416,800,628,445,-212,55.625,-33.758
10008030009,南投縣,草屯鎮,碧峰里,1476,607,805,868,671,-261,83.354,-30.069
10008030010,南投縣,草屯鎮,碧洲里,1005,328,594,445,411,-117,69.192,-26.292
10008030011,南投縣,草屯鎮,復興里,1000,383,607,608,393,-225,64.745,-37.007
10008030007,南投縣,草屯鎮,御史里,2043,811,1179,1214,864,-403,73.282,-33.196
10008030008,南投縣,草屯鎮,新豐里,1277,525,793,799,484,-274,61.034,-34.293
10008030013,南投縣,草屯鎮,新庄里,1318,476,773,676,545,-200,70.505,-29.586
10008030016,南投縣,草屯鎮,加老里,676,293,398,543,278,-250,69.849,-46.041
10008030015,南投縣,草屯鎮,石川里,557,196,233,349,324,-153,139.056,-43.84
10008030014,南投縣,草屯鎮,北投里,943,447,491,689,452,-242,92.057,-35.123
10008030006,南投縣,草屯鎮,富寮里,2492,1026,1257,1276,1235,-250,98.25,-19.592
10008030017,南投縣,草屯鎮,北勢里,576,258,329,398,247,-140,75.076,-35.176
10008030018,南投縣,草屯鎮,中原里,682,325,350,545,332,-220,94.857,-40.367
10008030019,南投縣,草屯鎮,南埔里,1460,601,712,843,748,-242,105.056,-28.707
10008030021,南投縣,草屯鎮,坪頂里,337,139,197,199,140,-60,71.066,-30.151
10008030020,南投縣,草屯鎮,土城里,553,192,342,254,211,-62,61.696,-24.409
10008030023,南投縣,草屯鎮,平林里,433,127,215,193,218,-66,101.395,-34.197
10008030022,南投縣,草屯鎮,雙冬里,668,235,338,353,330,-118,97.633,-33.428
10008100001,南投縣,國姓鄉,國姓村,506,205,277,271,229,-66,82.671,-24.354
10008100002,南投縣,國姓鄉,石門村,541,155,334,219,207,-64,61.976,-29.224
10008100003,南投縣,國姓鄉,大旗村,196,97,91,94,105,3,115.385,3.191
10008100005,南投縣,國姓鄉,長流村,425,131,234,136,191,-5,81.624,-3.676
10008100013,南投縣,國姓鄉,長豐村,226,65,125,57,101,8,80.8,14.035
10008100006,南投縣,國姓鄉,長福村,224,76,125,92,99,-16,79.2,-17.391
10008100004,南投縣,國姓鄉,北港村,539,188,253,271,286,-83,113.043,-30.627
10008100007,南投縣,國姓鄉,福龜村,606,171,337,271,269,-100,79.822,-36.9
10008100008,南投縣,國姓鄉,乾溝村,215,88,129,119,86,-31,66.667,-26.05
10008100009,南投縣,國姓鄉,柑林村,399,114,234,134,165,-20,70.513,-14.925
10008100012,南投縣,國姓鄉,大石村,207,66,124,84,83,-18,66.935,-21.429
10008100010,南投縣,國姓鄉,北山村,415,168,239,254,176,-86,73.64,-33.858
10008100011,南投縣,國姓鄉,南港村,469,148,290,186,179,-38,61.724,-20.43
10008020001,南投縣,埔里鎮,東門里,905,366,593,501,312,-135,52.614,-26.946
10008020031,南投縣,埔里鎮,杷城里,904,323,549,456,355,-133,64.663,-29.167
10008020010,南投縣,埔里鎮,枇杷里,2518,846,1556,1046,962,-200,61.825,-19.12
10008020011,南投縣,埔里鎮,水頭里,1269,459,597,524,672,-65,112.563,-12.405
10008020012,南投縣,埔里鎮,麒麟里,294,118,153,173,141,-55,92.157,-31.792
10008020013,南投縣,埔里鎮,珠格里,346,135,189,183,157,-48,83.069,-26.23
10008020014,南投縣,埔里鎮,溪南里,413,134,220,172,193,-38,87.727,-22.093
10008020003,南投縣,埔里鎮,西門里,983,377,596,506,387,-129,64.933,-25.494
10008020002,南投縣,埔里鎮,南門里,263,138,203,203,60,-65,29.557,-32.02
10008020004,南投縣,埔里鎮,北門里,771,263,497,334,274,-71,55.131,-21.257
10008020030,南投縣,埔里鎮,北安里,1157,420,744,552,413,-132,55.511,-23.913
10008020032,南投縣,埔里鎮,北梅里,1118,393,657,458,461,-65,70.167,-14.192
10008020033,南投縣,埔里鎮,泰安里,749,253,505,350,244,-97,48.317,-27.714
10008020027,南投縣,埔里鎮,大湳里,596,202,314,304,282,-102,89.809,-33.553
10008020028,南投縣,埔里鎮,蜈蚣里,757,314,469,397,288,-83,61.407,-20.907
10008020005,南投縣,埔里鎮,同聲里,769,269,444,356,325,-87,73.198,-24.438
10008020007,南投縣,埔里鎮,清新里,1205,452,731,533,474,-81,64.843,-15.197
10008020006,南投縣,埔里鎮,薰化里,383,161,268,206,115,-45,42.91,-21.845
10008020008,南投縣,埔里鎮,大城里,2027,732,1206,916,821,-184,68.076,-20.087
10008020009,南投縣,埔里鎮,籃城里,304,171,177,223,127,-52,71.751,-23.318
10008020015,南投縣,埔里鎮,桃米里,345,105,202,149,143,-44,70.792,-29.53
10008020016,南投縣,埔里鎮,成功里,96,27,59,52,37,-25,62.712,-48.077
10008020017,南投縣,埔里鎮,南村里,428,138,228,183,200,-45,87.719,-24.59
10008020018,南投縣,埔里鎮,愛蘭里,478,173,290,201,188,-28,64.828,-13.93
10008020019,南投縣,埔里鎮,鐵山里,539,215,330,272,209,-57,63.333,-20.956
10008020020,南投縣,埔里鎮,房里里,504,158,265,192,239,-34,90.189,-17.708
10008020021,南投縣,埔里鎮,向善里,223,114,134,126,89,-12,66.418,-9.524
10008020022,南投縣,埔里鎮,一新里,463,98,253,140,210,-42,83.004,-30.0
10008020029,南投縣,埔里鎮,合成里,479,189,247,326,232,-137,93.927,-42.025
10008020023,南投縣,埔里鎮,廣成里,349,139,198,164,151,-25,76.263,-15.244
10008020024,南投縣,埔里鎮,史港里,201,74,135,85,66,-11,48.889,-12.941
10008020025,南投縣,埔里鎮,福興里,284,166,135,199,149,-33,110.37,-16.583
10008020026,南投縣,埔里鎮,牛眠里,938,357,477,531,461,-174,96.646,-32.768
10008130010,南投縣,仁愛鄉,南豐村,358,70,288,88,70,-18,24.306,-20.455
10008130009,南投縣,仁愛鄉,大同村,516,96,418,126,98,-30,23.445,-23.81
10008130014,南投縣,仁愛鄉,榮興村,12,3,20,1,-8,2,-40.0,200.0
10008130011,南投縣,仁愛鄉,春陽村,220,30,203,39,17,-9,8.374,-23.077
10008130012,南投縣,仁愛鄉,精英村,141,19,134,32,7,-13,5.224,-40.625
10008130016,南投縣,仁愛鄉,都達村,82,13,98,13,-16,0,-16.327,0.0
10008130017,南投縣,仁愛鄉,德鹿谷村,71,17,,,,,,
10008130006,南投縣,仁愛鄉,發祥村,125,19,109,31,16,-12,14.679,-38.71
10008130005,南投縣,仁愛鄉,力行村,104,9,83,15,21,-6,25.301,-40.0
10008130015,南投縣,仁愛鄉,翠華村,79,16,77,30,2,-14,2.597,-46.667
10008130008,南投縣,仁愛鄉,親愛村,263,30,202,46,61,-16,30.198,-34.783
10008130013,南投縣,仁愛鄉,萬豐村,108,28,83,27,25,1,30.12,3.704
10008130001,南投縣,仁愛鄉,法治村,182,36,133,35,49,1,36.842,2.857
10008130002,南投縣,仁愛鄉,中正村,223,36,175,38,48,-2,27.429,-5.263
10008130003,南投縣,仁愛鄉,互助村,388,36,311,44,77,-8,24.759,-18.182
10008130004,南投縣,仁愛鄉,新生村,159,14,150,13,9,1,6.0,7.692
10008080001,南投縣,中寮鄉,廣興村,200,119,90,168,110,-49,122.222,-29.167
10008080002,南投縣,中寮鄉,崁頂村,148,41,88,81,60,-40,68.182,-49.383
10008080003,南投縣,中寮鄉,八仙村,232,104,134,131,98,-27,73.134,-20.611
10008080005,南投縣,中寮鄉,福盛村,211,91,110,108,101,-17,91.818,-15.741
10008080004,南投縣,中寮鄉,和興村,175,79,95,102,80,-23,84.211,-22.549
10008080007,南投縣,中寮鄉,復興村,79,41,52,51,27,-10,51.923,-19.608
10008080006,南投縣,中寮鄉,永平村,561,204,285,262,276,-58,96.842,-22.137
10008080008,南投縣,中寮鄉,中寮村,234,63,122,93,112,-30,91.803,-32.258
10008080009,南投縣,中寮鄉,廣福村,127,57,55,98,72,-41,130.909,-41.837
10008080010,南投縣,中寮鄉,永福村,417,140,234,183,183,-43,78.205,-23.497
10008080011,南投縣,中寮鄉,義和村,308,116,163,206,145,-90,88.957,-43.689
10008080012,南投縣,中寮鄉,清水村,258,99,113,126,145,-27,128.319,-21.429
10008080016,南投縣,中寮鄉,內城村,127,53,81,83,46,-30,56.79,-36.145
10008080013,南投縣,中寮鄉,龍安村,183,92,82,154,101,-62,123.171,-40.26
10008080018,南投縣,中寮鄉,爽文村,152,60,88,88,64,-28,72.727,-31.818
10008080014,南投縣,中寮鄉,龍岩村,203,79,111,111,92,-32,82.883,-28.829
10008080017,南投縣,中寮鄉,永芳村,169,55,76,76,93,-21,122.368,-27.632
10008080015,南投縣,中寮鄉,永和村,164,57,90,81,74,-24,82.222,-29.63
10008090002,南投縣,魚池鄉,魚池村,551,247,347,319,204,-72,58.79,-22.571
10008090001,南投縣,魚池鄉,東池村,450,181,287,260,163,-79,56.794,-30.385
10008090005,南投縣,魚池鄉,大林村,284,137,148,194,136,-57,91.892,-29.381
10008090006,南投縣,魚池鄉,東光村,304,125,157,175,147,-50,93.631,-28.571
10008090007,南投縣,魚池鄉,共和村,229,99,100,90,129,9,129.0,10.0
10008090004,南投縣,魚池鄉,新城村、共和村,466,195,100,90,366,105,366.0,116.667
10008090008,南投縣,魚池鄉,大雁村,171,61,107,98,64,-37,59.813,-37.755
10008090009,南投縣,魚池鄉,五城村,187,105,123,109,64,-4,52.033,-3.67
10008090003,南投縣,魚池鄉,中明村,277,102,142,165,135,-63,95.07,-38.182
10008090010,南投縣,魚池鄉,水社村,285,70,195,106,90,-36,46.154,-33.962
10008090013,南投縣,魚池鄉,日月村,263,86,166,144,97,-58,58.434,-40.278
10008090011,南投縣,魚池鄉,頭社村,227,70,121,135,106,-65,87.603,-48.148
10008090012,南投縣,魚池鄉,武登村,160,53,115,71,45,-18,39.13,-25.352
10008010001,南投縣,南投市,龍泉里,294,144,183,196,111,-52,60.656,-26.531
10008010002,南投縣,南投市,康壽里,499,232,322,316,177,-84,54.969,-26.582
10008010003,南投縣,南投市,三民里,308,139,166,165,142,-26,85.542,-15.758
10008010004,南投縣,南投市,仁和里,185,89,101,158,84,-69,83.168,-43.671
10008010005,南投縣,南投市,南投里,164,87,116,146,48,-59,41.379,-40.411
10008010006,南投縣,南投市,彰仁里,117,81,79,114,38,-33,48.101,-28.947
10008010007,南投縣,南投市,崇文里,287,147,217,207,70,-60,32.258,-28.986
10008010015,南投縣,南投市,三興里,1937,723,1253,956,684,-233,54.589,-24.372
10008010016,南投縣,南投市,三和里,997,422,674,571,323,-149,47.923,-26.095
10008010017,南投縣,南投市,嘉興里,672,363,319,475,353,-112,110.658,-23.579
10008010018,南投縣,南投市,嘉和里,1489,620,871,794,618,-174,70.953,-21.914
10008010012,南投縣,南投市,平和里,2108,873,1312,1123,796,-250,60.671,-22.262
10008010013,南投縣,南投市,振興里,676,335,362,489,314,-154,86.74,-31.493
10008010014,南投縣,南投市,千秋里,326,124,187,216,139,-92,74.332,-42.593
10008010010,南投縣,南投市,軍功里,1470,553,907,804,563,-251,62.073,-31.219
10008010011,南投縣,南投市,東山里,113,50,67,79,46,-29,68.657,-36.709
10008010028,南投縣,南投市,營南里,989,323,629,447,360,-124,57.234,-27.74
10008010027,南投縣,南投市,營北里,2673,765,2086,994,587,-229,28.14,-23.038
10008010029,南投縣,南投市,內興里,2165,606,1862,1096,303,-490,16.273,-44.708
10008010030,南投縣,南投市,內新里,1183,499,283,282,900,217,318.021,76.95
10008010034,南投縣,南投市,光輝里,193,60,178,108,15,-48,8.427,-44.444
10008010032,南投縣,南投市,光榮里,376,68,412,91,-36,-23,-8.738,-25.275
10008010033,南投縣,南投市,光明里,307,59,390,80,-83,-21,-21.282,-26.25
10008010031,南投縣,南投市,光華里,247,53,283,79,-36,-26,-12.721,-32.911
10008010008,南投縣,南投市,漳興里,913,425,529,562,384,-137,72.59,-24.377
10008010009,南投縣,南投市,漳和里,2604,1035,1516,1307,1088,-272,71.768,-20.811
10008010023,南投縣,南投市,平山里,1919,765,1057,978,862,-213,81.552,-21.779
10008010024,南投縣,南投市,新興里,1702,643,923,856,779,-213,84.399,-24.883
10008010025,南投縣,南投市,永豐里,992,363,554,546,438,-183,79.061,-33.516
10008010026,南投縣,南投市,福興里,1041,422,544,592,497,-170,91.36,-28.716
10008010022,南投縣,南投市,鳳山里,224,142,114,226,110,-84,96.491,-37.168
10008010020,南投縣,南投市,永興里,268,117,116,138,152,-21,131.034,-15.217
10008010021,南投縣,南投市,鳳鳴里,113,79,60,137,53,-58,88.333,-42.336
10008010019,南投縣,南投市,福山里,576,212,346,329,230,-117,66.474,-35.562
10008060001,南投縣,名間鄉,南雅村,352,158,207,213,145,-55,70.048,-25.822
10008060002,南投縣,名間鄉,中正村,1115,548,621,699,494,-151,79.549,-21.602
10008060003,南投縣,名間鄉,中山村,728,300,369,397,359,-97,97.29,-24.433
10008060004,南投縣,名間鄉,濁水村,477,245,282,327,195,-82,69.149,-25.076
10008060006,南投縣,名間鄉,新民村,276,169,150,220,126,-51,84.0,-23.182
10008060005,南投縣,名間鄉,炭寮村,269,150,129,190,140,-40,108.527,-21.053
10008060007,南投縣,名間鄉,新街村,1311,678,686,902,625,-224,91.108,-24.834
10008060008,南投縣,名間鄉,東湖村,450,232,259,331,191,-99,73.745,-29.909
10008060023,南投縣,名間鄉,仁和村,288,112,193,138,95,-26,49.223,-18.841
10008060009,南投縣,名間鄉,萬丹村,239,165,131,233,108,-68,82.443,-29.185
10008060010,南投縣,名間鄉,田仔村,365,188,162,275,203,-87,125.309,-31.636
10008060013,南投縣,名間鄉,大坑村,176,112,85,164,91,-52,107.059,-31.707
10008060011,南投縣,名間鄉,大庄村,483,352,230,476,253,-124,110.0,-26.05
10008060012,南投縣,名間鄉,廍下村,243,123,116,191,127,-68,109.483,-35.602
10008060015,南投縣,名間鄉,赤水村,290,194,183,270,107,-76,58.47,-28.148
10008060014,南投縣,名間鄉,竹圍村,259,147,130,211,129,-64,99.231,-30.332
10008060016,南投縣,名間鄉,三崙村,478,253,224,310,254,-57,113.393,-18.387
10008060017,南投縣,名間鄉,松山村,439,288,205,364,234,-76,114.146,-20.879
10008060018,南投縣,名間鄉,松柏村,341,186,167,249,174,-63,104.192,-25.301
10008060020,南投縣,名間鄉,崁腳村,288,124,194,125,94,-1,48.454,-0.8
10008060019,南投縣,名間鄉,埔中村,274,124,137,186,137,-62,100.0,-33.333
10008060021,南投縣,名間鄉,新厝村,248,108,153,144,95,-36,62.092,-25.0
10008060022,南投縣,名間鄉,新光村,504,280,269,338,235,-58,87.361,-17.16
10008050001,南投縣,集集鎮,集集里,393,146,262,183,131,-37,50.0,-20.219
10008050002,南投縣,集集鎮,和平里,302,106,177,153,125,-47,70.621,-30.719
10008050003,南投縣,集集鎮,林尾里,184,67,89,108,95,-41,106.742,-37.963
10008050004,南投縣,集集鎮,田寮里,357,172,184,202,173,-30,94.022,-14.851
10008050005,南投縣,集集鎮,隘寮里,145,65,71,92,74,-27,104.225,-29.348
10008050006,南投縣,集集鎮,玉映里,160,79,91,83,69,-4,75.824,-4.819
10008050007,南投縣,集集鎮,吳厝里,308,103,198,142,110,-39,55.556,-27.465
10008050008,南投縣,集集鎮,八張里,437,203,270,248,167,-45,61.852,-18.145
10008050009,南投縣,集集鎮,永昌里,298,155,163,187,135,-32,82.822,-17.112
10008050011,南投縣,集集鎮,廣明里,289,95,174,120,115,-25,66.092,-20.833
10008050010,南投縣,集集鎮,富山里,165,67,103,88,62,-21,60.194,-23.864
10008040001,南投縣,竹山鎮,竹山里,621,271,431,415,190,-144,44.084,-34.699
10008040002,南投縣,竹山鎮,中正里,181,95,112,118,69,-23,61.607,-19.492
10008040003,南投縣,竹山鎮,中山里,1436,612,836,842,600,-230,71.77,-27.316
10008040004,南投縣,竹山鎮,雲林里,1094,456,703,628,391,-172,55.619,-27.389
10008040028,南投縣,竹山鎮,竹圍里,669,278,425,403,244,-125,57.412,-31.017
10008040007,南投縣,竹山鎮,桂林里,965,608,623,645,342,-37,54.896,-5.736
10008040006,南投縣,竹山鎮,下坪里,374,143,239,220,135,-77,56.485,-35.0
10008040008,南投縣,竹山鎮,中和里,196,148,97,229,99,-81,102.062,-35.371
10008040009,南投縣,竹山鎮,中崎里,462,167,225,224,237,-57,105.333,-25.446
10008040026,南投縣,竹山鎮,秀林里,179,74,121,143,58,-69,47.934,-48.252
10008040019,南投縣,竹山鎮,大鞍里,107,43,75,56,32,-13,42.667,-23.214
10008040014,南投縣,竹山鎮,延和里,1423,615,830,884,593,-269,71.446,-30.43
10008040027,南投縣,竹山鎮,延祥里,1133,507,645,678,488,-171,75.659,-25.221
10008040012,南投縣,竹山鎮,延正里,474,190,247,287,227,-97,91.903,-33.798
10008040011,南投縣,竹山鎮,延平里,763,366,414,540,349,-174,84.3,-32.222
10008040013,南投縣,竹山鎮,延山里,205,127,148,168,57,-41,38.514,-24.405
10008040015,南投縣,竹山鎮,山崇里,504,222,271,326,233,-104,85.978,-31.902
10008040016,南投縣,竹山鎮,社寮里,416,182,219,250,197,-68,89.954,-27.2
10008040017,南投縣,竹山鎮,中央里,307,159,179,201,128,-42,71.508,-20.896
10008040018,南投縣,竹山鎮,富州里,185,72,120,112,65,-40,54.167,-35.714
10008040020,南投縣,竹山鎮,田子里,145,60,87,95,58,-35,66.667,-36.842
10008040005,南投縣,竹山鎮,硘磘里,521,248,313,330,208,-82,66.454,-24.848
10008040010,南投縣,竹山鎮,德興里,281,107,163,169,118,-62,72.393,-36.686
10008040021,南投縣,竹山鎮,福興里,192,53,137,84,55,-31,40.146,-36.905
10008040022,南投縣,竹山鎮,鯉魚里,189,86,109,105,80,-19,73.394,-18.095
10008040024,南投縣,竹山鎮,坪頂里,124,54,82,80,42,-26,51.22,-32.5
10008040023,南投縣,竹山鎮,瑞竹里,138,76,89,90,49,-14,55.056,-15.556
10008040025,南投縣,竹山鎮,桶頭里,209,88,99,125,110,-37,111.111,-29.6
10008070001,南投縣,鹿谷鄉,鹿谷村,551,226,341,314,210,-88,61.584,-28.025
10008070003,南投縣,鹿谷鄉,彰雅村,442,149,278,187,164,-38,58.993,-20.321
10008070004,南投縣,鹿谷鄉,廣興村,649,222,381,300,268,-78,70.341,-26.0
10008070010,南投縣,鹿谷鄉,永隆村,433,195,297,250,136,-55,45.791,-22.0
10008070009,南投縣,鹿谷鄉,鳳凰村,371,165,208,254,163,-89,78.365,-35.039
10008070005,南投縣,鹿谷鄉,內湖村,306,117,182,148,124,-31,68.132,-20.946
10008070008,南投縣,鹿谷鄉,和雅村,219,72,150,71,69,1,46.0,1.408
10008070006,南投縣,鹿谷鄉,竹林村,470,165,250,215,220,-50,88.0,-23.256
10008070007,南投縣,鹿谷鄉,竹豐村,328,109,207,122,121,-13,58.454,-10.656
10008070002,南投縣,鹿谷鄉,初鄉村,430,152,267,224,163,-72,61.049,-32.143
10008070011,南投縣,鹿谷鄉,秀峰村,190,78,86,128,104,-50,120.93,-39.062
10008070012,南投縣,鹿谷鄉,清水村,159,100,112,142,47,-42,41.964,-29.577
10008070013,南投縣,鹿谷鄉,瑞田村,173,69,77,120,96,-51,124.675,-42.5
10008110001,南投縣,水里鄉,水里村,215,76,126,95,89,-19,70.635,-20.0
10008110003,南投縣,水里鄉,新城村,364,205,223,227,141,-22,63.229,-9.692
10008110004,南投縣,水里鄉,中央村,183,72,143,91,40,-19,27.972,-20.879
10008110005,南投縣,水里鄉,城中村,272,120,207,136,65,-16,31.401,-11.765
10008110002,南投縣,水里鄉,農富村,145,67,87,100,58,-33,66.667,-33.0
10008110010,南投縣,水里鄉,車埕村,124,56,103,62,21,-6,20.388,-9.677
10008110011,南投縣,水里鄉,新興村,167,60,107,48,60,12,56.075,25.0
10008110006,南投縣,水里鄉,北埔村,325,118,203,165,122,-47,60.099,-28.485
10008110019,南投縣,水里鄉,南光村,504,198,278,237,226,-39,81.295,-16.456
10008110007,南投縣,水里鄉,鉅工村,271,84,202,163,69,-79,34.158,-48.466
10008110008,南投縣,水里鄉,永豐村,381,156,227,208,154,-52,67.841,-25.0
10008110015,南投縣,水里鄉,民和村,197,94,111,138,86,-44,77.477,-31.884
10008110009,南投縣,水里鄉,頂崁村,382,158,195,181,187,-23,95.897,-12.707
10008110012,南投縣,水里鄉,新山村,45,12,36,37,9,-25,25.0,-67.568
10008110013,南投縣,水里鄉,郡坑村,116,36,79,48,37,-12,46.835,-25.0
10008110014,南投縣,水里鄉,上安村,316,126,211,133,105,-7,49.763,-5.263
10008110018,南投縣,水里鄉,興隆村,69,29,52,44,17,-15,32.692,-34.091
10008110016,南投縣,水里鄉,永興村,78,66,48,77,30,-11,62.5,-14.286
10008110017,南投縣,水里鄉,玉峰村,212,126,101,150,111,-24,109.901,-16.0
10008120004,南投縣,信義鄉,明德村,433,141,333,172,100,-31,30.03,-18.023
10008120005,南投縣,信義鄉,愛國村,160,46,82,58,78,-12,95.122,-20.69
10008120006,南投縣,信義鄉,自強村,201,73,98,107,103,-34,105.102,-31.776
10008120014,南投縣,信義鄉,豐丘村,152,59,79,79,73,-20,92.405,-25.316
10008120013,南投縣,信義鄉,新鄉村,102,32,113,36,-11,-4,-9.735,-11.111
10008120007,南投縣,信義鄉,羅娜村,289,58,251,90,38,-32,15.139,-35.556
10008120008,南投縣,信義鄉,望美村,173,45,195,130,-22,-85,-11.282,-65.385
10008120015,南投縣,信義鄉,卡里布安村,78,45,,,,,,
10008120009,南投縣,信義鄉,同富村,408,138,215,196,193,-58,89.767,-29.592
10008120010,南投縣,信義鄉,神木村,172,53,96,64,76,-11,79.167,-17.188
10008120011,南投縣,信義鄉,東埔村,139,43,149,69,-10,-26,-6.711,-37.681
10008120001,南投縣,信義鄉,人和村,208,46,173,55,35,-9,20.231,-16.364
10008120002,南投縣,信義鄉,地利村,200,41,203,49,-3,-8,-1.478,-16.327
10008120012,南投縣,信義鄉,雙龍村,87,26,56,21,31,5,55.357,23.81
10008120003,南投縣,信義鄉,潭南村,132,20,107,16,25,4,23.364,25.0
68000050001,桃園市,蘆竹區,新興里,477,229,413,830,64,-601,15.496,-72.41
68000050002,桃園市,蘆竹區,中福里,662,247,567,1084,95,-837,16.755,-77.214
68000050037,桃園市,蘆竹區,上興里,794,194,653,720,141,-526,21.593,-73.056
68000050036,桃園市,蘆竹區,中興里,1172,263,892,920,280,-657,31.39,-71.413
68000050003,桃園市,蘆竹區,新莊里,938,351,807,1185,131,-834,16.233,-70.38
68000050022,桃園市,蘆竹區,上竹里,700,185,635,794,65,-609,10.236,-76.7
68000050023,桃園市,蘆竹區,宏竹里,538,205,449,715,89,-510,19.822,-71.329
68000050004,桃園市,蘆竹區,大竹里,1184,319,903,1030,281,-711,31.118,-69.029
68000050021,桃園市,蘆竹區,富竹里,240,121,146,428,94,-307,64.384,-71.729
68000050006,桃園市,蘆竹區,蘆竹里,625,221,523,1048,102,-827,19.503,-78.912
68000050018,桃園市,蘆竹區,南興里,1256,314,1126,1065,130,-751,11.545,-70.516
68000050028,桃園市,蘆竹區,福昌里,1149,221,1055,905,94,-684,8.91,-75.58
68000050029,桃園市,蘆竹區,福興里,785,168,660,692,125,-524,18.939,-75.723
68000050039,桃園市,蘆竹區,正興里,786,254,701,811,85,-557,12.126,-68.681
68000050027,桃園市,蘆竹區,順興里,933,209,739,777,194,-568,26.252,-73.102
68000050030,桃園市,蘆竹區,蘆興里,285,68,265,329,20,-261,7.547,-79.331
68000050017,桃園市,蘆竹區,南榮里,764,242,722,798,42,-556,5.817,-69.674
68000050007,桃園市,蘆竹區,南崁里,787,240,721,815,66,-575,9.154,-70.552
68000050008,桃園市,蘆竹區,錦興里,888,244,780,828,108,-584,13.846,-70.531
68000050035,桃園市,蘆竹區,興榮里,604,161,629,603,-25,-442,-3.975,-73.3
68000050020,桃園市,蘆竹區,錦中里,678,182,592,729,86,-547,14.527,-75.034
68000050019,桃園市,蘆竹區,長興里,407,90,383,474,24,-384,6.266,-81.013
68000050009,桃園市,蘆竹區,五福里,577,123,502,519,75,-396,14.94,-76.301
68000050033,桃園市,蘆竹區,中山里,801,161,639,588,162,-427,25.352,-72.619
68000050034,桃園市,蘆竹區,福祿里,610,160,524,653,86,-493,16.412,-75.498
68000050026,桃園市,蘆竹區,羊稠里,924,256,932,985,-8,-729,-0.858,-74.01
68000050032,桃園市,蘆竹區,吉祥里,958,247,967,781,-9,-534,-0.931,-68.374
68000050031,桃園市,蘆竹區,長壽里,1338,312,1228,1116,110,-804,8.958,-72.043
68000050025,桃園市,蘆竹區,營盤里,1251,308,1000,939,251,-631,25.1,-67.199
68000050038,桃園市,蘆竹區,營福里,710,175,636,643,74,-468,11.635,-72.784
68000050024,桃園市,蘆竹區,瓦窯里,839,183,706,570,133,-387,18.839,-67.895
68000050010,桃園市,蘆竹區,內厝里,360,147,321,598,39,-451,12.15,-75.418
68000050011,桃園市,蘆竹區,山鼻里,718,215,240,354,478,-139,199.167,-39.266
68000050012,桃園市,蘆竹區,山腳里,516,227,412,897,104,-670,25.243,-74.693
68000050013,桃園市,蘆竹區,外社里,177,108,150,469,27,-361,18.0,-76.972
68000050014,桃園市,蘆竹區,坑子里,185,110,160,457,25,-347,15.625,-75.93
68000050015,桃園市,蘆竹區,坑口里,337,113,320,661,17,-548,5.312,-82.905
68000050016,桃園市,蘆竹區,海湖里,532,118,430,496,102,-378,23.721,-76.21
68000050040,桃園市,蘆竹區,濱海里,399,115,315,449,84,-334,26.667,-74.388
68000070004,桃園市,龜山區,大同里,1293,314,1050,1164,243,-850,23.143,-73.024
68000070012,桃園市,龜山區,大坑里,336,141,290,435,46,-294,15.862,-67.586
68000070019,桃園市,龜山區,大崗里,784,215,662,741,122,-526,18.429,-70.985
68000070027,桃園市,龜山區,大湖里,1218,352,1015,1021,203,-669,20.0,-65.524
68000070028,桃園市,龜山區,大華里,1891,491,1665,1859,226,-1368,13.574,-73.588
68000070006,桃園市,龜山區,山頂里,1086,284,965,997,121,-713,12.539,-71.515
68000070005,桃園市,龜山區,山福里,639,199,587,678,52,-479,8.859,-70.649
68000070014,桃園市,龜山區,山德里,964,308,879,1096,85,-788,9.67,-71.898
68000070013,桃園市,龜山區,中興里,953,260,891,902,62,-642,6.958,-71.175
68000070009,桃園市,龜山區,公西里,285,102,271,356,14,-254,5.166,-71.348
68000070020,桃園市,龜山區,文化里,1737,457,1375,1352,362,-895,26.327,-66.198
68000070031,桃園市,龜山區,文青里,2574,653,1674,1454,900,-801,53.763,-55.089
68000070003,桃園市,龜山區,兔坑里,855,217,703,861,152,-644,21.622,-74.797
68000070022,桃園市,龜山區,幸福里,928,251,839,844,89,-593,10.608,-70.261
68000070029,桃園市,龜山區,長庚里,1246,363,755,1013,491,-650,65.033,-64.166
68000070011,桃園市,龜山區,南上里,336,144,327,467,9,-323,2.752,-69.165
68000070021,桃園市,龜山區,南美里,487,157,408,503,79,-346,19.363,-68.787
68000070025,桃園市,龜山區,迴龍里,1228,391,1110,1245,118,-854,10.631,-68.594
68000070007,桃園市,龜山區,陸光里,1469,94,1523,252,-54,-158,-3.546,-62.698
68000070015,桃園市,龜山區,新路里,1060,339,1078,1210,-18,-871,-1.67,-71.983
68000070030,桃園市,龜山區,新興里,651,113,582,349,69,-236,11.856,-67.622
68000070026,桃園市,龜山區,新嶺里,754,238,646,761,108,-523,16.718,-68.725
68000070032,桃園市,龜山區,楓福里,819,188,698,674,121,-486,17.335,-72.107
68000070001,桃園市,龜山區,楓樹里,849,263,733,969,116,-706,15.825,-72.859
68000070023,桃園市,龜山區,福源里,478,121,392,391,86,-270,21.939,-69.054
68000070008,桃園市,龜山區,精忠里,1477,223,1426,721,51,-498,3.576,-69.071
68000070010,桃園市,龜山區,樂善里,3453,862,836,1085,2617,-223,313.038,-20.553
68000070024,桃園市,龜山區,龍華里,731,247,586,749,145,-502,24.744,-67.023
68000070017,桃園市,龜山區,龍壽里,214,143,226,465,-12,-322,-5.31,-69.247
68000070002,桃園市,龜山區,龜山里,1316,387,1243,1342,73,-955,5.873,-71.162
68000070016,桃園市,龜山區,嶺頂里,667,240,654,856,13,-616,1.988,-71.963
68000070018,桃園市,龜山區,舊路里,666,166,558,589,108,-423,19.355,-71.817
68000010076,桃園市,桃園區,三元里,932,207,780,751,152,-544,19.487,-72.437
68000010045,桃園市,桃園區,三民里,1063,222,1106,862,-43,-640,-3.888,-74.246
68000010057,桃園市,桃園區,大有里,1477,289,1316,1078,161,-789,12.234,-73.191
68000010078,桃園市,桃園區,大業里,1078,256,1022,973,56,-717,5.479,-73.69
68000010046,桃園市,桃園區,大興里,961,306,901,1088,60,-782,6.659,-71.875
68000010010,桃園市,桃園區,汴洲里,1533,408,1123,1468,410,-1060,36.509,-72.207
68000010005,桃園市,桃園區,忠義里,786,164,738,628,48,-464,6.504,-73.885
68000010038,桃園市,桃園區,青溪里,1609,421,752,1073,857,-652,113.963,-60.764
68000010047,桃園市,桃園區,春日里,1113,331,1034,1202,79,-871,7.64,-72.463
68000010006,桃園市,桃園區,會稽里,895,181,2102,1673,-1207,-1492,-57.422,-89.181
68000010015,桃園市,桃園區,萬壽里,169,68,145,246,24,-178,16.552,-72.358
68000010079,桃園市,桃園區,福元里,1197,249,945,884,252,-635,26.667,-71.833
68000010081,桃園市,桃園區,檜樂里,1329,299,,,,,,
68000010058,桃園市,桃園區,寶山里,973,210,1666,1487,-693,-1277,-41.597,-85.878
68000010082,桃園市,桃園區,寶民里,886,178,,,,,,
68000010004,桃園市,桃園區,大林里,1290,354,1269,1265,21,-911,1.655,-72.016
68000010077,桃園市,桃園區,大樹里,743,167,688,808,55,-641,7.994,-79.332
68000010043,桃園市,桃園區,大豐里,1039,318,953,1089,86,-771,9.024,-70.799
68000010042,桃園市,桃園區,建國里,1146,347,1106,1109,40,-762,3.617,-68.711
68000010032,桃園市,桃園區,雲林里,1394,425,1304,1324,90,-899,6.902,-67.9
68000010044,桃園市,桃園區,福安里,813,265,869,882,-56,-617,-6.444,-69.955
68000010033,桃園市,桃園區,福林里,1280,367,1253,1389,27,-1022,2.155,-73.578
68000010041,桃園市,桃園區,豐林里,1359,392,1367,1468,-8,-1076,-0.585,-73.297
68000010020,桃園市,桃園區,中和里,229,106,261,351,-32,-245,-12.261,-69.801
68000010040,桃園市,桃園區,中興里,1273,322,1088,1373,185,-1051,17.004,-76.548
68000010001,桃園市,桃園區,文化里,251,88,227,258,24,-170,10.573,-65.891
68000010021,桃園市,桃園區,文昌里,151,70,134,246,17,-176,12.687,-71.545
68000010002,桃園市,桃園區,文明里,350,104,338,351,12,-247,3.55,-70.37
68000010031,桃園市,桃園區,北門里,303,121,290,440,13,-319,4.483,-72.5
68000010008,桃園市,桃園區,民生里,339,93,319,358,20,-265,6.27,-74.022
68000010009,桃園市,桃園區,永興里,297,134,309,436,-12,-302,-3.883,-69.266
68000010034,桃園市,桃園區,光興里,884,329,921,1213,-37,-884,-4.017,-72.877
68000010019,桃園市,桃園區,西門里,338,99,293,346,45,-247,15.358,-71.387
68000010025,桃園市,桃園區,西湖里,292,85,309,323,-17,-238,-5.502,-73.684
68000010003,桃園市,桃園區,武陵里,271,95,299,323,-28,-228,-9.365,-70.588
68000010007,桃園市,桃園區,長美里,167,99,168,301,-1,-202,-0.595,-67.11
68000010026,桃園市,桃園區,南門里,1275,330,1183,1292,92,-962,7.777,-74.458
68000010027,桃園市,桃園區,南華里,243,78,237,367,6,-289,2.532,-78.747
68000010023,桃園市,桃園區,中山里,1408,349,1481,1393,-73,-1044,-4.929,-74.946
68000010064,桃園市,桃園區,中平里,1044,288,1008,947,36,-659,3.571,-69.588
68000010030,桃園市,桃園區,中正里,1654,436,1481,1389,173,-953,11.681,-68.611
68000010029,桃園市,桃園區,中成里,1631,453,1041,1222,590,-769,56.676,-62.93
68000010062,桃園市,桃園區,中信里,1091,280,1131,1077,-40,-797,-3.537,-74.002
68000010065,桃園市,桃園區,中原里,1052,250,1090,925,-38,-675,-3.486,-72.973
68000010066,桃園市,桃園區,中泰里,1004,228,1021,805,-17,-577,-1.665,-71.677
68000010070,桃園市,桃園區,中聖里,1402,289,1352,957,50,-668,3.698,-69.801
68000010054,桃園市,桃園區,中路里,871,246,818,779,53,-533,6.479,-68.421
68000010055,桃園市,桃園區,中德里,1336,310,1318,1357,18,-1047,1.366,-77.155
68000010052,桃園市,桃園區,文中里,1385,341,878,886,507,-545,57.745,-61.512
68000010028,桃園市,桃園區,玉山里,960,332,911,1149,49,-817,5.379,-71.105
68000010053,桃園市,桃園區,泰山里,820,207,831,799,-11,-592,-1.324,-74.093
68000010035,桃園市,桃園區,龍山里,687,165,677,607,10,-442,1.477,-72.817
68000010060,桃園市,桃園區,龍安里,1240,245,1089,1011,151,-766,13.866,-75.767
68000010036,桃園市,桃園區,龍岡里,1325,284,1264,1052,61,-768,4.826,-73.004
68000010056,桃園市,桃園區,龍祥里,1233,244,1043,778,190,-534,18.217,-68.638
68000010071,桃園市,桃園區,龍壽里,1480,348,1217,1251,263,-903,21.611,-72.182
68000010059,桃園市,桃園區,龍鳳里,1737,435,1583,1396,154,-961,9.728,-68.84
68000010017,桃園市,桃園區,中埔里,684,164,362,615,322,-451,88.95,-73.333
68000010049,桃園市,桃園區,中寧里,1381,266,1297,1111,84,-845,6.476,-76.058
68000010069,桃園市,桃園區,北埔里,1080,209,993,914,87,-705,8.761,-77.133
68000010011,桃園市,桃園區,永安里,907,299,821,1238,86,-939,10.475,-75.848
68000010050,桃園市,桃園區,同安里,2050,460,1926,1956,124,-1496,6.438,-76.483
68000010072,桃園市,桃園區,同德里,1414,301,1405,1177,9,-876,0.641,-74.427
68000010061,桃園市,桃園區,自強里,1896,430,1693,1523,203,-1093,11.991,-71.766
68000010018,桃園市,桃園區,西埔里,569,208,511,821,58,-613,11.35,-74.665
68000010073,桃園市,桃園區,明德里,762,173,760,685,2,-512,0.263,-74.745
68000010012,桃園市,桃園區,東埔里,855,275,806,1066,49,-791,6.079,-74.203
68000010016,桃園市,桃園區,長安里,675,215,625,858,50,-643,8.0,-74.942
68000010063,桃園市,桃園區,長德里,1071,325,1003,1198,68,-873,6.78,-72.871
68000010048,桃園市,桃園區,信光里,1366,357,1235,1538,131,-1181,10.607,-76.788
68000010067,桃園市,桃園區,南埔里,1227,319,986,1108,241,-789,24.442,-71.209
68000010051,桃園市,桃園區,莊敬里,2005,414,2094,1608,-89,-1194,-4.25,-74.254
68000010024,桃園市,桃園區,慈文里,1251,323,1157,1290,94,-967,8.124,-74.961
68000010022,桃園市,桃園區,新埔里,1127,233,2289,1904,-1162,-1671,-50.765,-87.763
68000010075,桃園市,桃園區,瑞慶里,1237,266,1175,1086,62,-820,5.277,-75.506
68000010080,桃園市,桃園區,經國里,1187,220,,,,,,
68000010074,桃園市,桃園區,寶安里,1864,380,1637,1449,227,-1069,13.867,-73.775
68000010068,桃園市,桃園區,寶慶里,1342,318,1360,1200,-18,-882,-1.324,-73.5
68000010039,桃園市,桃園區,朝陽里,392,168,379,515,13,-347,3.43,-67.379
68000010037,桃園市,桃園區,成功里,905,245,927,877,-22,-632,-2.373,-72.064
68000010013,桃園市,桃園區,東門里,634,170,691,666,-57,-496,-8.249,-74.474
68000010014,桃園市,桃園區,東山里,458,125,362,448,96,-323,26.519,-72.098
68000060001,桃園市,大園區,大園里,1112,360,1013,1320,99,-960,9.773,-72.727
68000060002,桃園市,大園區,田心里,1289,313,1065,1449,224,-1136,21.033,-78.399
68000060003,桃園市,大園區,溪海里,773,216,624,855,149,-639,23.878,-74.737
68000060004,桃園市,大園區,和平里,239,103,212,428,27,-325,12.736,-75.935
68000060005,桃園市,大園區,橫峰里,735,177,2109,2452,-1374,-2275,-65.149,-92.781
68000060020,桃園市,大園區,青峰里,1078,232,,,,,,
68000060021,桃園市,大園區,青山里,941,221,,,,,,
68000060006,桃園市,大園區,五權里,917,288,676,1309,241,-1021,35.651,-77.998
68000060007,桃園市,大園區,埔心里,801,255,874,1282,-73,-1027,-8.352,-80.109
68000060008,桃園市,大園區,大海里,159,46,347,305,-188,-259,-54.179,-84.918
68000060010,桃園市,大園區,三石里,553,221,469,734,84,-513,17.91,-69.891
68000060011,桃園市,大園區,菓林里,1120,349,1084,1399,36,-1050,3.321,-75.054
68000060012,桃園市,大園區,竹圍里,227,54,542,650,-315,-596,-58.118,-91.692
68000060013,桃園市,大園區,海口里,201,41,285,312,-84,-271,-29.474,-86.859
68000060014,桃園市,大園區,沙崙里,237,58,390,489,-153,-431,-39.231,-88.139
68000060015,桃園市,大園區,後厝里,167,53,366,450,-199,-397,-54.372,-88.222
68000060016,桃園市,大園區,圳頭里,363,112,364,581,-1,-469,-0.275,-80.723
68000060017,桃園市,大園區,內海里,348,103,289,465,59,-362,20.415,-77.849
68000060018,桃園市,大園區,北港里,477,115,360,598,117,-483,32.5,-80.769
68000060019,桃園市,大園區,南港里,1489,292,802,931,687,-639,85.661,-68.636
68000120001,桃園市,觀音區,觀音里,541,157,446,546,95,-389,21.3,-71.245
68000120002,桃園市,觀音區,白玉里,170,45,170,200,0,-155,0.0,-77.5
68000120003,桃園市,觀音區,廣興里,264,75,225,255,39,-180,17.333,-70.588
68000120004,桃園市,觀音區,大潭里,361,86,314,490,47,-404,14.968,-82.449
68000120006,桃園市,觀音區,保生里,398,114,330,483,68,-369,20.606,-76.398
68000120005,桃園市,觀音區,武威里,187,57,156,221,31,-164,19.872,-74.208
68000120007,桃園市,觀音區,三和里,142,43,165,205,-23,-162,-13.939,-79.024
68000120008,桃園市,觀音區,新興里,152,46,129,169,23,-123,17.829,-72.781
68000120009,桃園市,觀音區,坑尾里,348,85,251,355,97,-270,38.645,-76.056
68000120010,桃園市,觀音區,金湖里,460,127,375,551,85,-424,22.667,-76.951
68000120011,桃園市,觀音區,藍埔里,451,133,418,625,33,-492,7.895,-78.72
68000120012,桃園市,觀音區,大同里,473,151,418,777,55,-626,13.158,-80.566
68000120013,桃園市,觀音區,大堀里,279,82,184,360,95,-278,51.63,-77.222
68000120014,桃園市,觀音區,崙坪里,772,287,694,1222,78,-935,11.239,-76.514
68000120015,桃園市,觀音區,富源里,893,213,714,769,179,-556,25.07,-72.302
68000120016,桃園市,觀音區,上大里,560,113,408,564,152,-451,37.255,-79.965
68000120017,桃園市,觀音區,新坡里,486,157,419,713,67,-556,15.99,-77.98
68000120018,桃園市,觀音區,廣福里,489,123,348,570,141,-447,40.517,-78.421
68000120019,桃園市,觀音區,塔腳里,165,37,140,198,25,-161,17.857,-81.313
68000120020,桃園市,觀音區,保障里,268,131,237,540,31,-409,13.08,-75.741
68000120021,桃園市,觀音區,草漯里,638,148,377,607,261,-459,69.231,-75.618
68000120024,桃園市,觀音區,草新里,1154,274,859,1030,295,-756,34.342,-73.398
68000120022,桃園市,觀音區,樹林里,863,158,557,677,306,-519,54.937,-76.662
68000120023,桃園市,觀音區,富林里,362,104,245,405,117,-301,47.755,-74.321
68000110001,桃園市,新屋區,新屋里,592,119,574,562,18,-443,3.136,-78.826
68000110002,桃園市,新屋區,新生里,920,182,816,748,104,-566,12.745,-75.668
68000110003,桃園市,新屋區,後湖里,324,73,254,286,70,-213,27.559,-74.476
68000110004,桃園市,新屋區,清華里,973,171,732,721,241,-550,32.923,-76.283
68000110010,桃園市,新屋區,石磊里,401,112,340,467,61,-355,17.941,-76.017
68000110009,桃園市,新屋區,東明里,316,85,273,297,43,-212,15.751,-71.38
68000110008,桃園市,新屋區,社子里,268,67,233,301,35,-234,15.021,-77.741
68000110006,桃園市,新屋區,埔頂里,558,121,426,460,132,-339,30.986,-73.696
68000110007,桃園市,新屋區,九斗里,457,97,351,531,106,-434,30.199,-81.733
68000110005,桃園市,新屋區,頭洲里,1013,222,809,913,204,-691,25.216,-75.685
68000110022,桃園市,新屋區,大坡里,229,61,183,297,46,-236,25.137,-79.461
68000110023,桃園市,新屋區,望間里,269,82,207,308,62,-226,29.952,-73.377
68000110021,桃園市,新屋區,後庄里,240,57,227,226,13,-169,5.727,-74.779
68000110019,桃園市,新屋區,蚵間里,138,57,118,220,20,-163,16.949,-74.091
68000110018,桃園市,新屋區,深圳里,134,32,120,125,14,-93,11.667,-74.4
68000110020,桃園市,新屋區,槺榔里,187,55,176,236,11,-181,6.25,-76.695
68000110017,桃園市,新屋區,笨港里,212,47,207,202,5,-155,2.415,-76.733
68000110016,桃園市,新屋區,永安里,424,120,415,486,9,-366,2.169,-75.309
68000110015,桃園市,新屋區,永興里,189,54,186,232,3,-178,1.613,-76.724
68000110011,桃園市,新屋區,下埔里,138,38,132,176,6,-138,4.545,-78.409
68000110013,桃園市,新屋區,石牌里,185,30,191,194,-6,-164,-3.141,-84.536
68000110012,桃園市,新屋區,下田里,326,85,298,332,28,-247,9.396,-74.398
68000110014,桃園市,新屋區,赤欄里,254,74,232,261,22,-187,9.483,-71.648
68000040018,桃園市,楊梅區,仁美里,1007,184,956,698,51,-514,5.335,-73.639
68000040011,桃園市,楊梅區,埔心里,312,108,314,344,-2,-236,-0.637,-68.605
68000040019,桃園市,楊梅區,光華里,840,143,812,494,28,-351,3.448,-71.053
68000040012,桃園市,楊梅區,金龍里,553,83,390,171,163,-88,41.795,-51.462
68000040014,桃園市,楊梅區,四維里,1301,154,1151,749,150,-595,13.032,-79.439
68000040035,桃園市,楊梅區,永平里,573,97,439,303,134,-206,30.524,-67.987
68000040013,桃園市,楊梅區,瑞塘里,1365,278,1135,1017,230,-739,20.264,-72.665
68000040034,桃園市,楊梅區,瑞坪里,1558,201,1250,838,308,-637,24.64,-76.014
68000040015,桃園市,楊梅區,梅溪里,906,165,834,625,72,-460,8.633,-73.6
68000040036,桃園市,楊梅區,瑞溪里,739,113,702,483,37,-370,5.271,-76.605
68000040028,桃園市,楊梅區,金溪里,1101,189,1009,641,92,-452,9.118,-70.515
68000040040,桃園市,楊梅區,三民里,779,148,708,486,71,-338,10.028,-69.547
68000040027,桃園市,楊梅區,楊明里,1937,283,1556,1196,381,-913,24.486,-76.338
68000040029,桃園市,楊梅區,裕成里,1039,173,912,566,127,-393,13.925,-69.435
68000040039,桃園市,楊梅區,裕新里,625,119,536,317,89,-198,16.604,-62.461
68000040010,桃園市,楊梅區,大同里,970,158,852,575,118,-417,13.85,-72.522
68000040026,桃園市,楊梅區,中山里,842,117,694,515,148,-398,21.326,-77.282
68000040001,桃園市,楊梅區,楊梅里,997,169,914,662,83,-493,9.081,-74.471
68000040002,桃園市,楊梅區,楊江里,305,49,275,194,30,-145,10.909,-74.742
68000040009,桃園市,楊梅區,梅新里,485,81,470,326,15,-245,3.191,-75.153
68000040003,桃園市,楊梅區,紅梅里,664,122,641,449,23,-327,3.588,-72.829
68000040004,桃園市,楊梅區,永寧里,1683,290,1363,1099,320,-809,23.478,-73.612
68000040005,桃園市,楊梅區,大平里,715,114,684,450,31,-336,4.532,-74.667
68000040030,桃園市,楊梅區,秀才里,797,163,663,668,134,-505,20.211,-75.599
68000040006,桃園市,楊梅區,東流里,607,161,440,545,167,-384,37.955,-70.459
68000040021,桃園市,楊梅區,豐野里,974,174,797,661,177,-487,22.208,-73.676
68000040020,桃園市,楊梅區,富岡里,463,83,394,302,69,-219,17.513,-72.517
68000040038,桃園市,楊梅區,富豐里,683,139,522,501,161,-362,30.843,-72.255
68000040022,桃園市,楊梅區,員本里,702,136,552,502,150,-366,27.174,-72.908
68000040024,桃園市,楊梅區,三湖里,652,119,476,493,176,-374,36.975,-75.862
68000040041,桃園市,楊梅區,頭湖里,763,117,568,448,195,-331,34.331,-73.884
68000040025,桃園市,楊梅區,上湖里,1379,230,1090,864,289,-634,26.514,-73.38
68000040008,桃園市,楊梅區,上田里,623,118,451,520,172,-402,38.137,-77.308
68000040016,桃園市,楊梅區,高山里,888,148,745,507,143,-359,19.195,-70.809
68000040037,桃園市,楊梅區,高上里,667,142,481,491,186,-349,38.669,-71.079
68000040031,桃園市,楊梅區,青山里,1052,189,854,577,198,-388,23.185,-67.244
68000040017,桃園市,楊梅區,高榮里,778,184,638,735,140,-551,21.944,-74.966
68000040033,桃園市,楊梅區,雙榮里,815,183,728,692,87,-509,11.951,-73.555
68000040032,桃園市,楊梅區,新榮里,747,170,731,687,16,-517,2.189,-75.255
68000040007,桃園市,楊梅區,水美里,948,194,845,764,103,-570,12.189,-74.607
68000040023,桃園市,楊梅區,瑞原里,723,130,692,498,31,-368,4.48,-73.896
68000020042,桃園市,中壢區,後寮里,1203,198,1035,796,168,-598,16.232,-75.126
68000020062,桃園市,中壢區,明德里,1108,264,1112,920,-4,-656,-0.36,-71.304
68000020063,桃園市,中壢區,至善里,1037,145,954,466,83,-321,8.7,-68.884
68000020082,桃園市,中壢區,龍慈里,1354,186,1278,731,76,-545,5.947,-74.555
68000020011,桃園市,中壢區,龍興里,1025,207,977,807,48,-600,4.913,-74.349
68000020065,桃園市,中壢區,龍德里,1122,143,1066,705,56,-562,5.253,-79.716
68000020029,桃園市,中壢區,龍岡里,1320,206,1314,683,6,-477,0.457,-69.839
68000020039,桃園市,中壢區,龍東里,1517,140,1563,499,-46,-359,-2.943,-71.944
68000020002,桃園市,中壢區,龍昌里,1695,259,1420,829,275,-570,19.366,-68.758
68000020001,桃園市,中壢區,龍平里,935,92,969,309,-34,-217,-3.509,-70.227
68000020012,桃園市,中壢區,仁美里,1455,251,1310,898,145,-647,11.069,-72.049
68000020072,桃園市,中壢區,仁福里,1250,184,1193,646,57,-462,4.778,-71.517
68000020076,桃園市,中壢區,華愛里,912,130,855,502,57,-372,6.667,-74.104
68000020016,桃園市,中壢區,普仁里,933,186,914,704,19,-518,2.079,-73.58
68000020060,桃園市,中壢區,普忠里,733,156,813,639,-80,-483,-9.84,-75.587
68000020061,桃園市,中壢區,普強里,978,205,1012,677,-34,-472,-3.36,-69.719
68000020053,桃園市,中壢區,普慶里,735,118,666,481,69,-363,10.36,-75.468
68000020037,桃園市,中壢區,信義里,1087,234,1117,864,-30,-630,-2.686,-72.917
68000020066,桃園市,中壢區,正義里,1021,223,1019,894,2,-671,0.196,-75.056
68000020017,桃園市,中壢區,普義里,1111,249,989,735,122,-486,12.336,-66.122
68000020069,桃園市,中壢區,德義里,655,167,611,515,44,-348,7.201,-67.573
68000020070,桃園市,中壢區,仁義里,856,230,832,764,24,-534,2.885,-69.895
68000020018,桃園市,中壢區,忠義里,955,179,857,721,98,-542,11.435,-75.173
68000020081,桃園市,中壢區,中興里,973,167,877,475,96,-308,10.946,-64.842
68000020008,桃園市,中壢區,自立里,1755,162,1909,423,-154,-261,-8.067,-61.702
68000020083,桃園市,中壢區,自信里,1444,201,1435,862,9,-661,0.627,-76.682
68000020077,桃園市,中壢區,莊敬里,1165,120,1236,385,-71,-265,-5.744,-68.831
68000020078,桃園市,中壢區,自治里,1215,149,1240,413,-25,-264,-2.016,-63.923
68000020005,桃園市,中壢區,內壢里,520,116,550,362,-30,-246,-5.455,-67.956
68000020006,桃園市,中壢區,成功里,1036,195,1013,731,23,-536,2.27,-73.324
68000020058,桃園市,中壢區,福德里,712,162,680,533,32,-371,4.706,-69.606
68000020026,桃園市,中壢區,中原里,896,185,845,716,51,-531,6.036,-74.162
68000020057,桃園市,中壢區,忠孝里,1125,207,1056,810,69,-603,6.534,-74.444
68000020087,桃園市,中壢區,興華里,1394,259,,,,,,
68000020033,桃園市,中壢區,復興里,722,195,1922,1560,-1200,-1365,-62.435,-87.5
68000020056,桃園市,中壢區,復華里,1408,273,1217,1009,191,-736,15.694,-72.944
68000020034,桃園市,中壢區,文化里,1842,417,1750,1651,92,-1234,5.257,-74.743
68000020059,桃園市,中壢區,和平里,564,140,548,459,16,-319,2.92,-69.499
68000020027,桃園市,中壢區,內定里,1304,313,1091,1365,213,-1052,19.523,-77.07
68000020038,桃園市,中壢區,石頭里,311,73,323,379,-12,-306,-3.715,-80.739
68000020015,桃園市,中壢區,中央里,899,242,852,785,47,-543,5.516,-69.172
68000020025,桃園市,中壢區,新興里,844,219,839,704,5,-485,0.596,-68.892
68000020084,桃園市,中壢區,林森里,956,185,988,714,-32,-529,-3.239,-74.09
68000020052,桃園市,中壢區,振興里,1305,291,1205,892,100,-601,8.299,-67.377
68000020021,桃園市,中壢區,東興里,785,169,761,713,24,-544,3.154,-76.297
68000020079,桃園市,中壢區,健行里,1046,216,1092,814,-46,-598,-4.212,-73.464
68000020031,桃園市,中壢區,水尾里,801,204,725,778,76,-574,10.483,-73.779
68000020085,桃園市,中壢區,金華里,1273,290,1260,813,13,-523,1.032,-64.33
68000020088,桃園市,中壢區,興福里,839,203,,,,,,
68000020036,桃園市,中壢區,忠福里,1011,204,1682,1479,-671,-1275,-39.893,-86.207
68000020073,桃園市,中壢區,幸福里,1345,318,1271,1170,74,-852,5.822,-72.821
68000020074,桃園市,中壢區,永福里,1366,325,1220,1214,146,-889,11.967,-73.229
68000020032,桃園市,中壢區,青埔里,2378,530,1314,1315,1064,-785,80.974,-59.696
68000020014,桃園市,中壢區,新街里,548,154,509,472,39,-318,7.662,-67.373
68000020041,桃園市,中壢區,興南里,776,175,726,547,50,-372,6.887,-68.007
68000020035,桃園市,中壢區,興國里,425,127,393,461,32,-334,8.142,-72.451
68000020080,桃園市,中壢區,興平里,524,160,521,633,3,-473,0.576,-74.724
68000020054,桃園市,中壢區,興和里,572,166,542,684,30,-518,5.535,-75.731
68000020004,桃園市,中壢區,永興里,172,49,197,195,-25,-146,-12.69,-74.872
68000020028,桃園市,中壢區,中壢里,138,38,146,147,-8,-109,-5.479,-74.15
68000020050,桃園市,中壢區,中榮里,208,77,175,206,33,-129,18.857,-62.621
68000020040,桃園市,中壢區,中建里,228,68,183,266,45,-198,24.59,-74.436
68000020045,桃園市,中壢區,舊明里,264,125,311,391,-47,-266,-15.113,-68.031
68000020024,桃園市,中壢區,新明里,775,188,725,855,50,-667,6.897,-78.012
68000020007,桃園市,中壢區,光明里,1264,265,1320,1057,-56,-792,-4.242,-74.929
68000020055,桃園市,中壢區,永光里,1133,246,1114,1104,19,-858,1.706,-77.717
68000020048,桃園市,中壢區,三民里,607,189,548,720,59,-531,10.766,-73.75
68000020044,桃園市,中壢區,五權里,1434,343,1244,1307,190,-964,15.273,-73.757
68000020064,桃園市,中壢區,五福里,694,172,700,786,-6,-614,-0.857,-78.117
68000020046,桃園市,中壢區,芝芭里,986,276,708,1002,278,-726,39.266,-72.455
68000020022,桃園市,中壢區,洽溪里,1190,294,1359,1442,-169,-1148,-12.436,-79.612
68000020086,桃園市,中壢區,青溪里,802,203,,,,,,
68000020051,桃園市,中壢區,內厝里,911,252,852,1193,59,-941,6.925,-78.877
68000020047,桃園市,中壢區,月眉里,944,344,705,1389,239,-1045,33.901,-75.234
68000020049,桃園市,中壢區,山東里,604,214,470,1003,134,-789,28.511,-78.664
68000020043,桃園市,中壢區,過嶺里,2025,446,1397,1607,628,-1161,44.953,-72.246
68000020067,桃園市,中壢區,龍安里,750,89,762,250,-12,-161,-1.575,-64.4
68000020013,桃園市,中壢區,仁愛里,741,150,718,577,23,-427,3.203,-74.003
68000020003,桃園市,中壢區,仁德里,887,162,807,467,80,-305,9.913,-65.31
68000020075,桃園市,中壢區,仁和里,1049,168,856,530,193,-362,22.547,-68.302
68000020030,桃園市,中壢區,仁祥里,805,107,699,358,106,-251,15.165,-70.112
68000020071,桃園市,中壢區,華勛里,1126,132,1040,439,86,-307,8.269,-69.932
68000020010,桃園市,中壢區,中堅里,1063,168,977,532,86,-364,8.802,-68.421
68000020020,桃園市,中壢區,興仁里,810,178,744,533,66,-355,8.871,-66.604
68000020019,桃園市,中壢區,中正里,1289,222,1237,748,52,-526,4.204,-70.321
68000020068,桃園市,中壢區,中山里,1233,219,1139,694,94,-475,8.253,-68.444
68000020023,桃園市,中壢區,篤行里,691,121,572,430,119,-309,20.804,-71.86
68000020009,桃園市,中壢區,自強里,973,154,1002,527,-29,-373,-2.894,-70.778
68000100012,桃園市,平鎮區,平鎮里,933,209,845,825,88,-616,10.414,-74.667
68000100027,桃園市,平鎮區,鎮興里,630,163,559,637,71,-474,12.701,-74.411
68000100013,桃園市,平鎮區,南勢里,1315,265,1215,1049,100,-784,8.23,-74.738
68000100033,桃園市,平鎮區,金星里,1720,276,1367,1069,353,-793,25.823,-74.181
68000100045,桃園市,平鎮區,平安里,1305,266,1069,952,236,-686,22.077,-72.059
68000100046,桃園市,平鎮區,平南里,1673,295,1415,1205,258,-910,18.233,-75.519
68000100015,桃園市,平鎮區,山峰里,530,118,547,361,-17,-243,-3.108,-67.313
68000100032,桃園市,平鎮區,福林里,819,202,764,671,55,-469,7.199,-69.896
68000100016,桃園市,平鎮區,湧光里,1224,297,1193,921,31,-624,2.598,-67.752
68000100014,桃園市,平鎮區,莊敬里,1307,241,1156,734,151,-493,13.062,-67.166
68000100029,桃園市,平鎮區,湧豐里,466,121,390,321,76,-200,19.487,-62.305
68000100030,桃園市,平鎮區,湧安里,1077,181,900,646,177,-465,19.667,-71.981
68000100006,桃園市,平鎮區,宋屋里,959,180,868,796,91,-616,10.484,-77.387
68000100043,桃園市,平鎮區,平興里,1320,286,1219,962,101,-676,8.285,-70.27
68000100004,桃園市,平鎮區,廣興里,1291,274,1303,1205,-12,-931,-0.921,-77.261
68000100031,桃園市,平鎮區,廣達里,871,275,805,893,66,-618,8.199,-69.205
68000100034,桃園市,平鎮區,廣仁里,860,208,792,737,68,-529,8.586,-71.777
68000100003,桃園市,平鎮區,復旦里,1265,243,1287,1002,-22,-759,-1.709,-75.749
68000100042,桃園市,平鎮區,復興里,1194,274,1140,1057,54,-783,4.737,-74.078
68000100005,桃園市,平鎮區,義民里,1232,248,1156,893,76,-645,6.574,-72.228
68000100028,桃園市,平鎮區,義興里,1554,385,1516,1440,38,-1055,2.507,-73.264
68000100001,桃園市,平鎮區,雙連里,970,217,947,857,23,-640,2.429,-74.679
68000100002,桃園市,平鎮區,高雙里,997,228,879,1030,118,-802,13.424,-77.864
68000100009,桃園市,平鎮區,北勢里,608,145,564,599,44,-454,7.801,-75.793
68000100041,桃園市,平鎮區,北華里,1008,225,989,736,19,-511,1.921,-69.429
68000100007,桃園市,平鎮區,新勢里,886,198,800,779,86,-581,10.75,-74.583
68000100040,桃園市,平鎮區,北安里,344,97,336,397,8,-300,2.381,-75.567
68000100037,桃園市,平鎮區,新榮里,1330,325,1196,1053,134,-728,11.204,-69.136
68000100008,桃園市,平鎮區,新富里,1507,314,1311,1052,196,-738,14.95,-70.152
68000100044,桃園市,平鎮區,新英里,1007,209,971,628,36,-419,3.708,-66.72
68000100035,桃園市,平鎮區,新貴里,736,203,660,699,76,-496,11.515,-70.959
68000100010,桃園市,平鎮區,北興里,882,196,774,800,108,-604,13.953,-75.5
68000100039,桃園市,平鎮區,金陵里,729,153,702,562,27,-409,3.846,-72.776
68000100011,桃園市,平鎮區,北貴里,962,207,854,847,108,-640,12.646,-75.561
68000100036,桃園市,平鎮區,北富里,852,232,817,850,35,-618,4.284,-72.706
68000100023,桃園市,平鎮區,建安里,996,217,863,856,133,-639,15.411,-74.65
68000100038,桃園市,平鎮區,華安里,1112,146,985,535,127,-389,12.893,-72.71
68000100025,桃園市,平鎮區,東安里,749,113,659,358,90,-245,13.657,-68.436
68000100026,桃園市,平鎮區,新安里,1072,196,941,653,131,-457,13.921,-69.985
68000100024,桃園市,平鎮區,東勢里,1098,298,972,1081,126,-783,12.963,-72.433
68000100017,桃園市,平鎮區,龍恩里,819,138,735,380,84,-242,11.429,-63.684
68000100018,桃園市,平鎮區,東社里,833,127,857,448,-24,-321,-2.8,-71.652
68000100021,桃園市,平鎮區,忠貞里,486,48,430,171,56,-123,13.023,-71.93
68000100020,桃園市,平鎮區,貿易里,612,85,615,303,-3,-218,-0.488,-71.947
68000100019,桃園市,平鎮區,龍興里,805,94,761,306,44,-212,5.782,-69.281
68000100022,桃園市,平鎮區,中正里,561,63,518,181,43,-118,8.301,-65.193
68000090001,桃園市,龍潭區,黃唐里,1142,228,850,841,292,-613,34.353,-72.889
68000090020,桃園市,龍潭區,永興里,624,151,575,504,49,-353,8.522,-70.04
68000090002,桃園市,龍潭區,中山里,1595,294,1287,1008,308,-714,23.932,-70.833
68000090021,桃園市,龍潭區,烏樹林里,573,130,498,513,75,-383,15.06,-74.659
68000090003,桃園市,龍潭區,烏林里,1017,179,830,661,187,-482,22.53,-72.92
68000090022,桃園市,龍潭區,百年里,1428,203,1373,591,55,-388,4.006,-65.651
68000090006,桃園市,龍潭區,凌雲里,869,196,735,588,134,-392,18.231,-66.667
68000090023,桃園市,龍潭區,龍祥里,881,126,765,520,116,-394,15.163,-75.769
68000090007,桃園市,龍潭區,八德里,1028,256,845,732,183,-476,21.657,-65.027
68000090024,桃園市,龍潭區,聖德里,641,167,558,579,83,-412,14.875,-71.157
68000090009,桃園市,龍潭區,上林里,1017,195,907,811,110,-616,12.128,-75.956
68000090011,桃園市,龍潭區,龍潭里,452,110,415,421,37,-311,8.916,-73.872
68000090025,桃園市,龍潭區,龍星里,1158,217,1081,751,77,-534,7.123,-71.105
68000090010,桃園市,龍潭區,中正里,1449,216,1371,776,78,-560,5.689,-72.165
68000090026,桃園市,龍潭區,上華里,881,128,888,495,-7,-367,-0.788,-74.141
68000090013,桃園市,龍潭區,九龍里,960,128,851,590,109,-462,12.808,-78.305
68000090027,桃園市,龍潭區,武漢里,366,71,343,213,23,-142,6.706,-66.667
68000090032,桃園市,龍潭區,祥和里,376,62,236,244,140,-182,59.322,-74.59
68000090028,桃園市,龍潭區,東興里,904,183,987,477,-83,-294,-8.409,-61.635
68000090014,桃園市,龍潭區,中興里,1021,159,960,613,61,-454,6.354,-74.062
68000090029,桃園市,龍潭區,北興里,553,88,483,288,70,-200,14.493,-69.444
68000090015,桃園市,龍潭區,佳安里,1024,131,1041,526,-17,-395,-1.633,-75.095
68000090017,桃園市,龍潭區,三坑里,318,79,268,338,50,-259,18.657,-76.627
68000090018,桃園市,龍潭區,大平里,734,151,562,471,172,-320,30.605,-67.941
68000090019,桃園市,龍潭區,三林里,889,161,925,524,-36,-363,-3.892,-69.275
68000090030,桃園市,龍潭區,建林里,1254,146,1257,527,-3,-381,-0.239,-72.296
68000090031,桃園市,龍潭區,富林里,960,131,960,476,0,-345,0.0,-72.479
68000090004,桃園市,龍潭區,高平里,675,139,578,618,97,-479,16.782,-77.508
68000090012,桃園市,龍潭區,高原里,866,207,821,799,45,-592,5.481,-74.093
68000090016,桃園市,龍潭區,三和里,163,43,719,468,-556,-425,-77.33,-90.812
68000090033,桃園市,龍潭區,渴望里,723,109,,,,,,
68000090008,桃園市,龍潭區,三水里,131,45,88,193,43,-148,48.864,-76.684
68000080001,桃園市,八德區,興仁里,816,208,1496,1440,-680,-1232,-45.455,-85.556
68000080051,桃園市,八德區,興中里,987,185,,,,,,
68000080002,桃園市,八德區,福興里,953,216,1667,1703,-714,-1487,-42.831,-87.317
68000080049,桃園市,八德區,福元里,896,217,,,,,,
68000080050,桃園市,八德區,福德里,635,155,,,,,,
68000080003,桃園市,八德區,瑞豐里,1258,252,904,766,354,-514,39.159,-67.102
68000080040,桃園市,八德區,瑞興里,663,214,491,630,172,-416,35.031,-66.032
68000080028,桃園市,八德區,瑞泰里,858,187,769,809,89,-622,11.573,-76.885
68000080004,桃園市,八德區,瑞發里,795,170,759,560,36,-390,4.743,-69.643
68000080005,桃園市,八德區,瑞德里,905,175,833,508,72,-333,8.643,-65.551
68000080006,桃園市,八德區,瑞祥里,837,145,869,430,-32,-285,-3.682,-66.279
68000080044,桃園市,八德區,廣德里,586,185,567,634,19,-449,3.351,-70.82
68000080007,桃園市,八德區,廣興里,666,188,581,686,85,-498,14.63,-72.595
68000080008,桃園市,八德區,廣隆里,1070,222,1020,926,50,-704,4.902,-76.026
68000080009,桃園市,八德區,竹園里,683,150,606,645,77,-495,12.706,-76.744
68000080010,桃園市,八德區,霄裡里,434,119,373,450,61,-331,16.354,-73.556
68000080045,桃園市,八德區,龍友里,718,81,728,223,-10,-142,-1.374,-63.677
68000080038,桃園市,八德區,茄明里,1123,227,929,847,194,-620,20.883,-73.2
68000080011,桃園市,八德區,茄苳里,434,114,396,531,38,-417,9.596,-78.531
68000080047,桃園市,八德區,永豐里,577,186,496,566,81,-380,16.331,-67.138
68000080012,桃園市,八德區,高明里,750,225,682,808,68,-583,9.971,-72.153
68000080039,桃園市,八德區,高城里,737,192,622,613,115,-421,18.489,-68.679
68000080013,桃園市,八德區,白鷺里,566,157,570,695,-4,-538,-0.702,-77.41
68000080014,桃園市,八德區,大湳里,759,209,633,838,126,-629,19.905,-75.06
68000080032,桃園市,八德區,大發里,419,128,361,447,58,-319,16.066,-71.365
68000080026,桃園市,八德區,大仁里,841,294,772,977,69,-683,8.938,-69.908
68000080033,桃園市,八德區,大明里,720,221,651,811,69,-590,10.599,-72.75
68000080015,桃園市,八德區,大安里,685,207,579,791,106,-584,18.307,-73.831
68000080034,桃園市,八德區,大竹里,287,130,230,377,57,-247,24.783,-65.517
68000080016,桃園市,八德區,大興里,947,228,744,770,203,-542,27.285,-70.39
68000080041,桃園市,八德區,大愛里,637,111,585,480,52,-369,8.889,-76.875
68000080025,桃園市,八德區,大華里,573,136,561,502,12,-366,2.139,-72.908
68000080048,桃園市,八德區,大順里,531,114,521,495,10,-381,1.919,-76.97
68000080017,桃園市,八德區,大和里,2000,352,1778,1225,222,-873,12.486,-71.265
68000080029,桃園市,八德區,大昌里,608,179,622,562,-14,-383,-2.251,-68.149
68000080024,桃園市,八德區,大信里,816,186,695,574,121,-388,17.41,-67.596
68000080046,桃園市,八德區,陸光里,1276,117,1350,378,-74,-261,-5.481,-69.048
68000080035,桃園市,八德區,大慶里,280,75,267,287,13,-212,4.869,-73.868
68000080018,桃園市,八德區,大同里,285,95,290,374,-5,-279,-1.724,-74.599
68000080019,桃園市,八德區,大成里,673,218,669,756,4,-538,0.598,-71.164
68000080020,桃園市,八德區,大義里,811,180,813,638,-2,-458,-0.246,-71.787
68000080021,桃園市,八德區,大忠里,379,100,369,345,10,-245,2.71,-71.014
68000080027,桃園市,八德區,大智里,1170,180,1098,691,72,-511,6.557,-73.951
68000080042,桃園市,八德區,大宏里,1290,267,977,809,313,-542,32.037,-66.996
68000080030,桃園市,八德區,大正里,941,207,837,794,104,-587,12.425,-73.929
68000080022,桃園市,八德區,大福里,1276,331,1187,1132,89,-801,7.498,-70.76
68000080031,桃園市,八德區,大強里,673,221,567,765,106,-544,18.695,-71.111
68000080023,桃園市,八德區,大勇里,904,253,819,869,85,-616,10.379,-70.886
68000080037,桃園市,八德區,大榮里,426,103,369,393,57,-290,15.447,-73.791
68000080036,桃園市,八德區,大千里,514,113,482,363,32,-250,6.639,-68.871
68000080043,桃園市,八德區,大漢里,974,186,860,676,114,-490,13.256,-72.485
68000030001,桃園市,大溪區,興和里,269,133,234,435,35,-302,14.957,-69.425
68000030002,桃園市,大溪區,福仁里,140,88,146,307,-6,-219,-4.11,-71.336
68000030025,桃園市,大溪區,田心里,689,305,681,1167,8,-862,1.175,-73.865
68000030003,桃園市,大溪區,一心里,850,324,779,1043,71,-719,9.114,-68.936
68000030004,桃園市,大溪區,一德里,873,379,748,1251,125,-872,16.711,-69.704
68000030005,桃園市,大溪區,月眉里,177,91,131,344,46,-253,35.115,-73.547
68000030006,桃園市,大溪區,永福里,106,91,113,318,-7,-227,-6.195,-71.384
68000030011,桃園市,大溪區,康安里,178,96,163,416,15,-320,9.202,-76.923
68000030012,桃園市,大溪區,義和里,247,119,245,475,2,-356,0.816,-74.947
68000030007,桃園市,大溪區,美華里,450,235,413,821,37,-586,8.959,-71.376
68000030008,桃園市,大溪區,福安里,301,148,280,612,21,-464,7.5,-75.817
68000030009,桃園市,大溪區,復興里,124,53,121,225,3,-172,2.479,-76.444
68000030010,桃園市,大溪區,新峰里,85,39,111,190,-26,-151,-23.423,-79.474
68000030014,桃園市,大溪區,中新里,243,124,234,438,9,-314,3.846,-71.689
68000030013,桃園市,大溪區,瑞興里,397,156,376,627,21,-471,5.585,-75.12
68000030017,桃園市,大溪區,仁善里,1028,195,855,925,173,-730,20.234,-78.919
68000030028,桃園市,大溪區,仁美里,834,159,665,574,169,-415,25.414,-72.3
68000030016,桃園市,大溪區,僑愛里,869,88,898,193,-29,-105,-3.229,-54.404
68000030015,桃園市,大溪區,仁義里,694,106,733,327,-39,-221,-5.321,-67.584
68000030027,桃園市,大溪區,仁和里,1052,308,907,906,145,-598,15.987,-66.004
68000030018,桃園市,大溪區,仁愛里,1175,279,930,1016,245,-737,26.344,-72.539
68000030019,桃園市,大溪區,仁武里,665,165,676,588,-11,-423,-1.627,-71.939
68000030026,桃園市,大溪區,仁文里,855,204,786,683,69,-479,8.779,-70.132
68000030021,桃園市,大溪區,南興里,873,262,789,988,84,-726,10.646,-73.482
68000030023,桃園市,大溪區,光明里,586,90,576,346,10,-256,1.736,-73.988
68000030020,桃園市,大溪區,員林里,352,105,289,312,63,-207,21.799,-66.346
68000030024,桃園市,大溪區,三元里,799,119,791,402,8,-283,1.011,-70.398
68000030022,桃園市,大溪區,瑞源里,741,226,633,818,108,-592,17.062,-72.372
68000130001,桃園市,復興區,三民里,394,80,345,320,49,-240,14.203,-75.0
68000130002,桃園市,復興區,澤仁里,282,53,309,128,-27,-75,-8.738,-58.594
68000130004,桃園市,復興區,霞雲里,192,13,134,30,58,-17,43.284,-56.667
68000130003,桃園市,復興區,義盛里,191,4,186,34,5,-30,2.688,-88.235
68000130009,桃園市,復興區,羅浮里,236,30,238,95,-2,-65,-0.84,-68.421
68000130005,桃園市,復興區,長興里,109,14,114,43,-5,-29,-4.386,-67.442
68000130007,桃園市,復興區,奎輝里,133,24,164,41,-31,-17,-18.902,-41.463
68000130010,桃園市,復興區,高義里,47,1,88,35,-41,-34,-46.591,-97.143
68000130006,桃園市,復興區,三光里,84,11,106,22,-22,-11,-20.755,-50.0
68000130008,桃園市,復興區,華陵里,133,12,162,124,-29,-112,-17.901,-90.323
10002010036,宜蘭縣,宜蘭市,民族里,377,131,431,504,-54,-373,-12.529,-74.008
10002010037,宜蘭縣,宜蘭市,建軍里,287,88,295,352,-8,-264,-2.712,-75.0
10002010044,宜蘭縣,宜蘭市,泰山里,324,94,318,339,6,-245,1.887,-72.271
10002010035,宜蘭縣,宜蘭市,負郭里,492,237,458,721,34,-484,7.424,-67.129
10002010038,宜蘭縣,宜蘭市,思源里,857,274,882,885,-25,-611,-2.834,-69.04
10002010043,宜蘭縣,宜蘭市,七結里,603,168,535,563,68,-395,12.71,-70.16
10002010039,宜蘭縣,宜蘭市,文化里,540,188,562,668,-22,-480,-3.915,-71.856
10002010040,宜蘭縣,宜蘭市,復興里,523,137,561,523,-38,-386,-6.774,-73.805
10002010002,宜蘭縣,宜蘭市,民權里,311,76,297,297,14,-221,4.714,-74.411
10002010001,宜蘭縣,宜蘭市,神農里,440,147,489,564,-49,-417,-10.02,-73.936
10002010045,宜蘭縣,宜蘭市,大新里,110,59,127,178,-17,-119,-13.386,-66.854
10002010018,宜蘭縣,宜蘭市,新民里,221,102,224,426,-3,-324,-1.339,-76.056
10002010008,宜蘭縣,宜蘭市,進士里,479,135,397,529,82,-394,20.655,-74.48
10002010009,宜蘭縣,宜蘭市,南橋里,234,86,208,313,26,-227,12.5,-72.524
10002010012,宜蘭縣,宜蘭市,凱旋里,235,81,183,337,52,-256,28.415,-75.964
10002010011,宜蘭縣,宜蘭市,南津里,469,143,432,444,37,-301,8.565,-67.793
10002010010,宜蘭縣,宜蘭市,建業里,424,178,311,537,113,-359,36.334,-66.853
10002010047,宜蘭縣,宜蘭市,擺厘里,527,186,530,701,-3,-515,-0.566,-73.466
10002010015,宜蘭縣,宜蘭市,延平里,598,167,508,681,90,-514,17.717,-75.477
10002010041,宜蘭縣,宜蘭市,成功里,568,182,482,669,86,-487,17.842,-72.795
10002010014,宜蘭縣,宜蘭市,東村里,403,146,357,488,46,-342,12.885,-70.082
10002010042,宜蘭縣,宜蘭市,新東里,580,158,524,645,56,-487,10.687,-75.504
10002010013,宜蘭縣,宜蘭市,黎明里,310,124,274,441,36,-317,13.139,-71.882
10002010016,宜蘭縣,宜蘭市,七張里,216,78,181,350,35,-272,19.337,-77.714
10002010023,宜蘭縣,宜蘭市,孝廉里,184,86,150,299,34,-213,22.667,-71.237
10002010019,宜蘭縣,宜蘭市,東門里,133,83,128,273,5,-190,3.906,-69.597
10002010021,宜蘭縣,宜蘭市,小東里,287,94,243,390,44,-296,18.107,-75.897
10002010022,宜蘭縣,宜蘭市,菜園里,238,73,243,281,-5,-208,-2.058,-74.021
10002010017,宜蘭縣,宜蘭市,慈安里,306,92,273,333,33,-241,12.088,-72.372
10002010046,宜蘭縣,宜蘭市,中興里,538,167,428,586,110,-419,25.701,-71.502
10002010024,宜蘭縣,宜蘭市,新生里,408,203,321,621,87,-418,27.103,-67.311
10002010025,宜蘭縣,宜蘭市,茭白里,364,141,305,463,59,-322,19.344,-69.546
10002010026,宜蘭縣,宜蘭市,北津里,343,153,273,554,70,-401,25.641,-72.383
10002010027,宜蘭縣,宜蘭市,梅洲里,480,228,389,768,91,-540,23.393,-70.312
10002010034,宜蘭縣,宜蘭市,南門里,194,73,224,329,-30,-256,-13.393,-77.812
10002010031,宜蘭縣,宜蘭市,中山里,166,52,137,209,29,-157,21.168,-75.12
10002010032,宜蘭縣,宜蘭市,西門里,280,171,242,497,38,-326,15.702,-65.594
10002010028,宜蘭縣,宜蘭市,北門里,154,95,165,323,-11,-228,-6.667,-70.588
10002020028,宜蘭縣,羅東鎮,開明里,177,114,191,376,-14,-262,-7.33,-69.681
10002020004,宜蘭縣,羅東鎮,大新里,242,137,221,397,21,-260,9.502,-65.491
10002020005,宜蘭縣,羅東鎮,東安里,570,275,450,844,120,-569,26.667,-67.417
10002020006,宜蘭縣,羅東鎮,新群里,461,226,321,730,140,-504,43.614,-69.041
10002020007,宜蘭縣,羅東鎮,羅莊里,577,247,481,710,96,-463,19.958,-65.211
10002020008,宜蘭縣,羅東鎮,南昌里,357,153,336,537,21,-384,6.25,-71.508
10002020009,宜蘭縣,羅東鎮,南豪里,199,118,205,344,-6,-226,-2.927,-65.698
10002020010,宜蘭縣,羅東鎮,成功里,262,121,239,392,23,-271,9.623,-69.133
10002020011,宜蘭縣,羅東鎮,仁德里,193,86,195,293,-2,-207,-1.026,-70.648
10002020030,宜蘭縣,羅東鎮,仁和里,150,84,123,260,27,-176,21.951,-67.692
10002020029,宜蘭縣,羅東鎮,中山里,163,114,152,379,11,-265,7.237,-69.921
10002020016,宜蘭縣,羅東鎮,漢民里,588,229,560,863,28,-634,5.0,-73.465
10002020027,宜蘭縣,羅東鎮,維揚里,539,236,478,762,61,-526,12.762,-69.029
10002020017,宜蘭縣,羅東鎮,西安里,440,202,395,682,45,-480,11.392,-70.381
10002020018,宜蘭縣,羅東鎮,北成里,451,205,385,709,66,-504,17.143,-71.086
10002020026,宜蘭縣,羅東鎮,國華里,720,324,693,1076,27,-752,3.896,-69.888
10002020019,宜蘭縣,羅東鎮,賢文里,569,231,560,829,9,-598,1.607,-72.135
10002020020,宜蘭縣,羅東鎮,公正里,401,200,429,697,-28,-497,-6.527,-71.306
10002020021,宜蘭縣,羅東鎮,集祥里,139,66,135,235,4,-169,2.963,-71.915
10002020022,宜蘭縣,羅東鎮,信義里,493,246,484,741,9,-495,1.86,-66.802
10002020025,宜蘭縣,羅東鎮,樹林里,663,287,641,915,22,-628,3.432,-68.634
10002020023,宜蘭縣,羅東鎮,竹林里,412,216,395,766,17,-550,4.304,-71.802
10002020024,宜蘭縣,羅東鎮,仁愛里,597,273,520,964,77,-691,14.808,-71.68
10002030001,宜蘭縣,蘇澳鎮,龍德里,460,191,381,816,79,-625,20.735,-76.593
10002030002,宜蘭縣,蘇澳鎮,頂寮里,126,60,110,272,16,-212,14.545,-77.941
10002030003,宜蘭縣,蘇澳鎮,永榮里,602,267,478,901,124,-634,25.941,-70.366
10002030004,宜蘭縣,蘇澳鎮,存仁里,116,60,92,254,24,-194,26.087,-76.378
10002030005,宜蘭縣,蘇澳鎮,港邊里,157,91,170,328,-13,-237,-7.647,-72.256
10002030007,宜蘭縣,蘇澳鎮,隘丁里,470,217,385,766,85,-549,22.078,-71.671
10002030008,宜蘭縣,蘇澳鎮,新城里,239,112,192,384,47,-272,24.479,-70.833
10002030027,宜蘭縣,蘇澳鎮,聖愛里,370,136,351,569,19,-433,5.413,-76.098
10002030009,宜蘭縣,蘇澳鎮,聖湖里,401,139,381,414,20,-275,5.249,-66.425
10002030010,宜蘭縣,蘇澳鎮,蘇西里,348,167,353,536,-5,-369,-1.416,-68.843
10002030011,宜蘭縣,蘇澳鎮,蘇北里,160,57,179,196,-19,-139,-10.615,-70.918
10002030012,宜蘭縣,蘇澳鎮,蘇南里,81,57,88,128,-7,-71,-7.955,-55.469
10002030013,宜蘭縣,蘇澳鎮,蘇東里,73,16,75,90,-2,-74,-2.667,-82.222
10002030014,宜蘭縣,蘇澳鎮,長安里,76,35,65,118,11,-83,16.923,-70.339
10002030015,宜蘭縣,蘇澳鎮,永光里,79,24,88,96,-9,-72,-10.227,-75.0
10002030016,宜蘭縣,蘇澳鎮,永春里,71,35,74,119,-3,-84,-4.054,-70.588
10002030017,宜蘭縣,蘇澳鎮,永樂里,71,32,61,92,10,-60,16.393,-65.217
10002030018,宜蘭縣,蘇澳鎮,南安里,128,71,134,198,-6,-127,-4.478,-64.141
10002030019,宜蘭縣,蘇澳鎮,南正里,101,57,95,238,6,-181,6.316,-76.05
10002030020,宜蘭縣,蘇澳鎮,南成里,104,68,109,219,-5,-151,-4.587,-68.95
10002030021,宜蘭縣,蘇澳鎮,南興里,164,52,184,240,-20,-188,-10.87,-78.333
10002030022,宜蘭縣,蘇澳鎮,南寧里,128,64,138,205,-10,-141,-7.246,-68.78
10002030023,宜蘭縣,蘇澳鎮,南建里,125,94,121,281,4,-187,3.306,-66.548
10002030024,宜蘭縣,蘇澳鎮,東澳里,45,12,38,51,7,-39,18.421,-76.471
10002030025,宜蘭縣,蘇澳鎮,南強里,72,41,62,160,10,-119,16.129,-74.375
10002030026,宜蘭縣,蘇澳鎮,朝陽里,69,60,53,162,16,-102,30.189,-62.963
10002040001,宜蘭縣,頭城鎮,石城里,40,10,22,59,18,-49,81.818,-83.051
10002040002,宜蘭縣,頭城鎮,大里里,80,18,77,113,3,-95,3.896,-84.071
10002040024,宜蘭縣,頭城鎮,龜山里,88,27,89,138,-1,-111,-1.124,-80.435
10002040003,宜蘭縣,頭城鎮,大溪里,103,30,78,185,25,-155,32.051,-83.784
10002040004,宜蘭縣,頭城鎮,合興里,50,11,31,55,19,-44,61.29,-80.0
10002040005,宜蘭縣,頭城鎮,更新里,152,49,134,217,18,-168,13.433,-77.419
10002040006,宜蘭縣,頭城鎮,外澳里,116,32,101,142,15,-110,14.851,-77.465
10002040007,宜蘭縣,頭城鎮,港口里,105,37,77,138,28,-101,36.364,-73.188
10002040008,宜蘭縣,頭城鎮,武營里,288,92,276,289,12,-197,4.348,-68.166
10002040009,宜蘭縣,頭城鎮,大坑里,232,89,187,288,45,-199,24.064,-69.097
10002040010,宜蘭縣,頭城鎮,城東里,143,52,150,152,-7,-100,-4.667,-65.789
10002040011,宜蘭縣,頭城鎮,城北里,98,29,111,87,-13,-58,-11.712,-66.667
10002040012,宜蘭縣,頭城鎮,城西里,93,29,91,104,2,-75,2.198,-72.115
10002040013,宜蘭縣,頭城鎮,城南里,100,46,121,144,-21,-98,-17.355,-68.056
10002040014,宜蘭縣,頭城鎮,竹安里,267,73,233,342,34,-269,14.592,-78.655
10002040015,宜蘭縣,頭城鎮,新建里,379,120,310,390,69,-270,22.258,-69.231
10002040016,宜蘭縣,頭城鎮,拔雅里,392,110,294,422,98,-312,33.333,-73.934
10002040017,宜蘭縣,頭城鎮,福成里,144,48,119,176,25,-128,21.008,-72.727
10002040018,宜蘭縣,頭城鎮,金面里,294,102,275,321,19,-219,6.909,-68.224
10002040019,宜蘭縣,頭城鎮,金盈里,114,36,102,123,12,-87,11.765,-70.732
10002040020,宜蘭縣,頭城鎮,頂埔里,234,113,200,287,34,-174,17.0,-60.627
10002040021,宜蘭縣,頭城鎮,下埔里,127,46,105,202,22,-156,20.952,-77.228
10002040022,宜蘭縣,頭城鎮,中崙里,135,58,128,184,7,-126,5.469,-68.478
10002040023,宜蘭縣,頭城鎮,二城里,167,58,132,207,35,-149,26.515,-71.981
10002050001,宜蘭縣,礁溪鄉,白雲村,285,118,195,332,90,-214,46.154,-64.458
10002050002,宜蘭縣,礁溪鄉,玉石村,338,158,297,409,41,-251,13.805,-61.369
10002050003,宜蘭縣,礁溪鄉,德陽村,864,247,721,771,143,-524,19.834,-67.964
10002050004,宜蘭縣,礁溪鄉,大忠村,442,147,408,514,34,-367,8.333,-71.401
10002050005,宜蘭縣,礁溪鄉,大義村,92,58,82,146,10,-88,12.195,-60.274
10002050006,宜蘭縣,礁溪鄉,六結村,237,83,248,322,-11,-239,-4.435,-74.224
10002050007,宜蘭縣,礁溪鄉,二龍村,147,79,132,315,15,-236,11.364,-74.921
10002050008,宜蘭縣,礁溪鄉,時潮村,193,84,143,381,50,-297,34.965,-77.953
10002050009,宜蘭縣,礁溪鄉,玉田村,245,177,242,584,3,-407,1.24,-69.692
10002050010,宜蘭縣,礁溪鄉,三民村,343,150,283,559,60,-409,21.201,-73.166
10002050011,宜蘭縣,礁溪鄉,林美村,122,55,113,231,9,-176,7.965,-76.19
10002050012,宜蘭縣,礁溪鄉,白鵝村,118,52,103,190,15,-138,14.563,-72.632
10002050013,宜蘭縣,礁溪鄉,玉光村,188,54,143,275,45,-221,31.469,-80.364
10002050014,宜蘭縣,礁溪鄉,光武村,204,117,150,329,54,-212,36.0,-64.438
10002050015,宜蘭縣,礁溪鄉,吳沙村,405,179,345,687,60,-508,17.391,-73.945
10002050016,宜蘭縣,礁溪鄉,龍潭村,457,234,368,855,89,-621,24.185,-72.632
10002050017,宜蘭縣,礁溪鄉,匏崙村,110,51,123,205,-13,-154,-10.569,-75.122
10002050018,宜蘭縣,礁溪鄉,二結村,36,35,38,140,-2,-105,-5.263,-75.0
10002060001,宜蘭縣,壯圍鄉,吉祥村,451,165,352,624,99,-459,28.125,-73.558
10002060014,宜蘭縣,壯圍鄉,古結村,165,102,142,277,23,-175,16.197,-63.177
10002060002,宜蘭縣,壯圍鄉,美福村,320,121,263,426,57,-305,21.673,-71.596
10002060003,宜蘭縣,壯圍鄉,新南村,153,84,125,240,28,-156,22.4,-65.0
10002060004,宜蘭縣,壯圍鄉,東港村,93,35,79,201,14,-166,17.722,-82.587
10002060005,宜蘭縣,壯圍鄉,復興村,173,71,146,372,27,-301,18.493,-80.914
10002060006,宜蘭縣,壯圍鄉,過嶺村,152,87,140,341,12,-254,8.571,-74.487
10002060007,宜蘭縣,壯圍鄉,永鎮村,99,64,90,215,9,-151,10.0,-70.233
10002060008,宜蘭縣,壯圍鄉,忠孝村,311,161,279,593,32,-432,11.47,-72.85
10002060009,宜蘭縣,壯圍鄉,古亭村,241,113,198,395,43,-282,21.717,-71.392
10002060010,宜蘭縣,壯圍鄉,功勞村,183,59,158,344,25,-285,15.823,-82.849
10002060011,宜蘭縣,壯圍鄉,美城村,366,163,301,550,65,-387,21.595,-70.364
10002060012,宜蘭縣,壯圍鄉,新社村,154,60,122,257,32,-197,26.23,-76.654
10002060013,宜蘭縣,壯圍鄉,大福村,205,105,192,368,13,-263,6.771,-71.467
10002070001,宜蘭縣,員山鄉,員山村,961,352,831,1311,130,-959,15.644,-73.15
10002070002,宜蘭縣,員山鄉,尚德村,288,116,261,496,27,-380,10.345,-76.613
10002070003,宜蘭縣,員山鄉,惠好村,257,94,198,474,59,-380,29.798,-80.169
10002070004,宜蘭縣,員山鄉,七賢村,296,97,236,318,60,-221,25.424,-69.497
10002070005,宜蘭縣,員山鄉,深溝村,332,154,271,501,61,-347,22.509,-69.261
10002070006,宜蘭縣,員山鄉,蓁巷村,126,82,119,323,7,-241,5.882,-74.613
10002070007,宜蘭縣,員山鄉,內城村,208,80,187,263,21,-183,11.23,-69.582
10002070008,宜蘭縣,員山鄉,中華村,62,41,74,154,-12,-113,-16.216,-73.377
10002070009,宜蘭縣,員山鄉,永和村,240,124,222,430,18,-306,8.108,-71.163
10002070010,宜蘭縣,員山鄉,頭分村,190,76,164,307,26,-231,15.854,-75.244
10002070011,宜蘭縣,員山鄉,枕山村,242,178,232,634,10,-456,4.31,-71.924
10002070012,宜蘭縣,員山鄉,同樂村,322,154,275,612,47,-458,17.091,-74.837
10002070013,宜蘭縣,員山鄉,湖東村,112,47,99,207,13,-160,13.131,-77.295
10002070014,宜蘭縣,員山鄉,逸仙村,122,55,93,245,29,-190,31.183,-77.551
10002070015,宜蘭縣,員山鄉,湖北村,121,56,128,222,-7,-166,-5.469,-74.775
10002070016,宜蘭縣,員山鄉,湖西村,133,97,127,318,6,-221,4.724,-69.497
10002080002,宜蘭縣,冬山鄉,珍珠村,239,140,175,518,64,-378,36.571,-72.973
10002080003,宜蘭縣,冬山鄉,補城村,179,86,141,315,38,-229,26.95,-72.698
10002080004,宜蘭縣,冬山鄉,三奇村,97,46,99,219,-2,-173,-2.02,-78.995
10002080005,宜蘭縣,冬山鄉,大興村,123,60,77,268,46,-208,59.74,-77.612
10002080006,宜蘭縣,冬山鄉,東城村,212,112,175,370,37,-258,21.143,-69.73
10002080007,宜蘭縣,冬山鄉,香和村,434,216,293,798,141,-582,48.123,-72.932
10002080008,宜蘭縣,冬山鄉,南興村,497,200,350,825,147,-625,42.0,-75.758
10002080010,宜蘭縣,冬山鄉,安平村,82,58,59,222,23,-164,38.983,-73.874
10002080009,宜蘭縣,冬山鄉,冬山村,113,68,108,207,5,-139,4.63,-67.15
10002080011,宜蘭縣,冬山鄉,太和村,237,169,178,475,59,-306,33.146,-64.421
10002080012,宜蘭縣,冬山鄉,八寶村,122,55,93,262,29,-207,31.183,-79.008
10002080013,宜蘭縣,冬山鄉,丸山村,196,91,135,411,61,-320,45.185,-77.859
10002080014,宜蘭縣,冬山鄉,中山村,56,30,55,152,1,-122,1.818,-80.263
10002080015,宜蘭縣,冬山鄉,順安村,705,345,552,1277,153,-932,27.717,-72.984
10002080016,宜蘭縣,冬山鄉,永美村,524,251,375,818,149,-567,39.733,-69.315
10002080001,宜蘭縣,冬山鄉,武淵村,198,110,117,353,81,-243,69.231,-68.839
10002080017,宜蘭縣,冬山鄉,群英村,731,363,637,1262,94,-899,14.757,-71.236
10002080018,宜蘭縣,冬山鄉,清溝村,620,339,541,980,79,-641,14.603,-65.408
10002080019,宜蘭縣,冬山鄉,鹿埔村,364,231,242,641,122,-410,50.413,-63.963
10002080020,宜蘭縣,冬山鄉,得安村,131,59,150,218,-19,-159,-12.667,-72.936
10002080021,宜蘭縣,冬山鄉,廣興村,360,190,306,621,54,-431,17.647,-69.404
10002080022,宜蘭縣,冬山鄉,廣安村,308,121,238,454,70,-333,29.412,-73.348
10002080023,宜蘭縣,冬山鄉,柯林村,314,150,247,501,67,-351,27.126,-70.06
10002080024,宜蘭縣,冬山鄉,大進村,84,71,79,230,5,-159,6.329,-69.13
10002090001,宜蘭縣,五結鄉,三興村,349,129,227,575,122,-446,53.744,-77.565
10002090002,宜蘭縣,五結鄉,二結村,370,148,295,490,75,-342,25.424,-69.796
10002090003,宜蘭縣,五結鄉,鎮安村,456,231,359,733,97,-502,27.019,-68.486
10002090004,宜蘭縣,五結鄉,上四村,293,121,239,421,54,-300,22.594,-71.259
10002090005,宜蘭縣,五結鄉,中興村,212,116,162,339,50,-223,30.864,-65.782
10002090006,宜蘭縣,五結鄉,四結村,501,200,409,700,92,-500,22.494,-71.429
10002090007,宜蘭縣,五結鄉,福興村,275,133,218,521,57,-388,26.147,-74.472
10002090008,宜蘭縣,五結鄉,五結村,568,265,453,890,115,-625,25.386,-70.225
10002090010,宜蘭縣,五結鄉,協和村,533,245,355,853,178,-608,50.141,-71.278
10002090009,宜蘭縣,五結鄉,大吉村,633,268,514,925,119,-657,23.152,-71.027
10002090011,宜蘭縣,五結鄉,孝威村,242,128,169,470,73,-342,43.195,-72.766
10002090012,宜蘭縣,五結鄉,錦眾村,210,120,199,356,11,-236,5.528,-66.292
10002090013,宜蘭縣,五結鄉,利澤村,265,114,187,485,78,-371,41.711,-76.495
10002090014,宜蘭縣,五結鄉,成興村,480,225,284,861,196,-636,69.014,-73.868
10002090015,宜蘭縣,五結鄉,季新村,408,220,286,713,122,-493,42.657,-69.144
10002100001,宜蘭縣,三星鄉,員山村,33,19,37,46,-4,-27,-10.811,-58.696
10002100002,宜蘭縣,三星鄉,天山村,58,33,56,91,2,-58,3.571,-63.736
10002100003,宜蘭縣,三星鄉,天福村,88,56,76,158,12,-102,15.789,-64.557
10002100012,宜蘭縣,三星鄉,萬德村,58,33,80,158,-22,-125,-27.5,-79.114
10002100013,宜蘭縣,三星鄉,貴林村,94,16,71,117,23,-101,32.394,-86.325
10002100014,宜蘭縣,三星鄉,萬富村,93,40,97,184,-4,-144,-4.124,-78.261
10002100004,宜蘭縣,三星鄉,雙賢村,90,50,71,175,19,-125,26.761,-71.429
10002100005,宜蘭縣,三星鄉,人和村,78,29,64,94,14,-65,21.875,-69.149
10002100006,宜蘭縣,三星鄉,義德村,173,62,171,235,2,-173,1.17,-73.617
10002100007,宜蘭縣,三星鄉,集慶村,193,56,162,267,31,-211,19.136,-79.026
10002100008,宜蘭縣,三星鄉,月眉村,118,63,116,190,2,-127,1.724,-66.842
10002100009,宜蘭縣,三星鄉,拱照村,146,50,118,277,28,-227,23.729,-81.949
10002100011,宜蘭縣,三星鄉,行健村,111,77,90,241,21,-164,23.333,-68.05
10002100010,宜蘭縣,三星鄉,大隱村,727,316,519,1020,208,-704,40.077,-69.02
10002100015,宜蘭縣,三星鄉,大義村,190,96,153,367,37,-271,24.183,-73.842
10002100016,宜蘭縣,三星鄉,尚武村,107,55,97,190,10,-135,10.309,-71.053
10002100017,宜蘭縣,三星鄉,大洲村,254,179,222,525,32,-346,14.414,-65.905
10002100018,宜蘭縣,三星鄉,尾塹村,209,112,168,437,41,-325,24.405,-74.371
10002110001,宜蘭縣,大同鄉,寒溪村,253,6,249,39,4,-33,1.606,-84.615
10002110002,宜蘭縣,大同鄉,崙埤村,178,5,163,21,15,-16,9.202,-76.19
10002110003,宜蘭縣,大同鄉,松羅村,146,7,137,63,9,-56,6.569,-88.889
10002110004,宜蘭縣,大同鄉,復興村,53,12,53,47,0,-35,0.0,-74.468
10002110005,宜蘭縣,大同鄉,英士村,55,16,76,22,-21,-6,-27.632,-27.273
10002110006,宜蘭縣,大同鄉,樂水村,111,7,97,15,14,-8,14.433,-53.333
10002110007,宜蘭縣,大同鄉,太平村,14,4,11,7,3,-3,27.273,-42.857
10002110010,宜蘭縣,大同鄉,茂安村,58,2,43,15,15,-13,34.884,-86.667
10002110008,宜蘭縣,大同鄉,四季村,125,14,151,34,-26,-20,-17.219,-58.824
10002110009,宜蘭縣,大同鄉,南山村,96,12,94,32,2,-20,2.128,-62.5
10002120003,宜蘭縣,南澳鄉,東岳村,162,7,125,28,37,-21,29.6,-75.0
10002120001,宜蘭縣,南澳鄉,南澳村,295,22,245,52,50,-30,20.408,-57.692
10002120002,宜蘭縣,南澳鄉,碧候村,258,16,205,31,53,-15,25.854,-48.387
10002120004,宜蘭縣,南澳鄉,金岳村,85,6,79,7,6,-1,7.595,-14.286
10002120005,宜蘭縣,南澳鄉,武塔村,118,9,107,23,11,-14,10.28,-60.87
10002120006,宜蘭縣,南澳鄉,金洋村,84,4,105,21,-21,-17,-20.0,-80.952
10002120007,宜蘭縣,南澳鄉,澳花村,196,21,204,25,-8,-4,-3.922,-16.0
09020010001,金門縣,金城鎮,東門里,544,27,843,111,-299,-84,-35.469,-75.676
09020010003,金門縣,金城鎮,南門里,608,36,928,134,-320,-98,-34.483,-73.134
09020010002,金門縣,金城鎮,西門里,1220,75,1768,254,-548,-179,-30.995,-70.472
09020010004,金門縣,金城鎮,北門里,439,30,636,87,-197,-57,-30.975,-65.517
09020010008,金門縣,金城鎮,賢庵里,590,30,701,145,-111,-115,-15.835,-79.31
09020010006,金門縣,金城鎮,金水里,297,23,401,53,-104,-30,-25.935,-56.604
09020010005,金門縣,金城鎮,古城里,417,27,617,112,-200,-85,-32.415,-75.893
09020010007,金門縣,金城鎮,珠沙里,347,20,442,57,-95,-37,-21.493,-64.912
09020040001,金門縣,金寧鄉,古寧村,258,12,411,67,-153,-55,-37.226,-82.09
09020040002,金門縣,金寧鄉,安美村,616,64,681,139,-65,-75,-9.545,-53.957
09020040004,金門縣,金寧鄉,湖埔村,971,58,1227,298,-256,-240,-20.864,-80.537
09020040005,金門縣,金寧鄉,榜林村,593,40,787,142,-194,-102,-24.651,-71.831
09020040006,金門縣,金寧鄉,盤山村,587,46,972,308,-385,-262,-39.609,-85.065
09020040003,金門縣,金寧鄉,后盤村,206,18,259,45,-53,-27,-20.463,-60.0
09020050004,金門縣,烈嶼鄉,林湖村,387,14,543,69,-156,-55,-28.729,-79.71
09020050005,金門縣,烈嶼鄉,黃埔村,164,7,207,22,-43,-15,-20.773,-68.182
09020050003,金門縣,烈嶼鄉,西口村,184,20,295,49,-111,-29,-37.627,-59.184
09020050002,金門縣,烈嶼鄉,上林村,148,8,171,13,-23,-5,-13.45,-38.462
09020050001,金門縣,烈嶼鄉,上岐村,287,11,410,46,-123,-35,-30.0,-76.087
09020060001,金門縣,烏坵鄉,大坵村,32,0,15,4,17,-4,113.333,-100.0
09020060002,金門縣,烏坵鄉,小坵村,14,1,15,3,-1,-2,-6.667,-66.667
09020030001,金門縣,金湖鎮,新市里,482,30,745,94,-263,-64,-35.302,-68.085
09020030002,金門縣,金湖鎮,山外里,460,23,560,91,-100,-68,-17.857,-74.725
09020030007,金門縣,金湖鎮,溪湖里,182,12,214,23,-32,-11,-14.953,-47.826
09020030008,金門縣,金湖鎮,蓮庵里,225,6,307,47,-82,-41,-26.71,-87.234
09020030004,金門縣,金湖鎮,料羅里,320,24,352,73,-32,-49,-9.091,-67.123
09020030006,金門縣,金湖鎮,新湖里,1050,73,1259,269,-209,-196,-16.6,-72.862
09020030003,金門縣,金湖鎮,正義里,346,18,450,66,-104,-48,-23.111,-72.727
09020030005,金門縣,金湖鎮,瓊林里,419,25,563,89,-144,-64,-25.577,-71.91
09020020001,金門縣,金沙鎮,汶沙里,643,29,853,112,-210,-83,-24.619,-74.107
09020020005,金門縣,金沙鎮,何斗里,261,10,349,31,-88,-21,-25.215,-67.742
09020020008,金門縣,金沙鎮,浦山里,250,15,401,45,-151,-30,-37.656,-66.667
09020020006,金門縣,金沙鎮,西園里,168,6,232,33,-64,-27,-27.586,-81.818
09020020007,金門縣,金沙鎮,官嶼里,201,12,335,32,-134,-20,-40.0,-62.5
09020020002,金門縣,金沙鎮,三山里,215,15,300,36,-85,-21,-28.333,-58.333
09020020003,金門縣,金沙鎮,大洋里,129,16,200,16,-71,0,-35.5,0.0
09020020004,金門縣,金沙鎮,光前里,264,12,368,68,-104,-56,-28.261,-82.353
10013010004,屏東縣,屏東市,大同里,240,262,172,365,68,-103,39.535,-28.219
10013010001,屏東縣,屏東市,光榮里,309,253,267,366,42,-113,15.73,-30.874
10013010008,屏東縣,屏東市,大埔里,294,205,207,348,87,-143,42.029,-41.092
10013010012,屏東縣,屏東市,維新里,435,371,408,728,27,-357,6.618,-49.038
10013010015,屏東縣,屏東市,楠樹里,333,332,201,399,132,-67,65.672,-16.792
10013010018,屏東縣,屏東市,金泉里,199,177,169,336,30,-159,17.751,-47.321
10013010020,屏東縣,屏東市,橋南里,267,171,264,337,3,-166,1.136,-49.258
10013010021,屏東縣,屏東市,橋北里,194,135,173,220,21,-85,12.139,-38.636
10013010026,屏東縣,屏東市,大連里,974,458,2177,2034,-1203,-1576,-55.26,-77.483
10013010082,屏東縣,屏東市,豐年里,1140,591,,,,,,
10013010025,屏東縣,屏東市,豐田里,780,458,789,928,-9,-470,-1.141,-50.647
10013010023,屏東縣,屏東市,豐榮里,575,352,533,674,42,-322,7.88,-47.774
10013010024,屏東縣,屏東市,豐源里,767,448,860,782,-93,-334,-10.814,-42.711
10013010022,屏東縣,屏東市,長春里,328,198,373,449,-45,-251,-12.064,-55.902
10013010030,屏東縣,屏東市,瑞光里,1613,950,1498,1629,115,-679,7.677,-41.682
10013010028,屏東縣,屏東市,湖南里,154,170,128,310,26,-140,20.312,-45.161
10013010027,屏東縣,屏東市,湖西里,199,207,198,476,1,-269,0.505,-56.513
10013010029,屏東縣,屏東市,歸心里,149,170,116,358,33,-188,28.448,-52.514
10013010055,屏東縣,屏東市,清溪里,810,445,758,921,52,-476,6.86,-51.683
10013010053,屏東縣,屏東市,大武里,1684,950,1532,1866,152,-916,9.922,-49.089
10013010081,屏東縣,屏東市,崇武里,1033,294,923,331,110,-37,11.918,-11.178
10013010054,屏東縣,屏東市,前進里,534,490,425,788,109,-298,25.647,-37.817
10013010050,屏東縣,屏東市,永光里,222,179,161,286,61,-107,37.888,-37.413
10013010056,屏東縣,屏東市,長安里,391,344,286,550,105,-206,36.713,-37.455
10013010051,屏東縣,屏東市,大洲里,136,237,123,397,13,-160,10.569,-40.302
10013010049,屏東縣,屏東市,安鎮里,301,282,287,551,14,-269,4.878,-48.82
10013010042,屏東縣,屏東市,公館里,220,208,194,475,26,-267,13.402,-56.211
10013010041,屏東縣,屏東市,新興里,363,330,348,635,15,-305,4.31,-48.031
10013010031,屏東縣,屏東市,新生里,1007,706,946,1322,61,-616,6.448,-46.596
10013010032,屏東縣,屏東市,頂宅里,100,100,70,168,30,-68,42.857,-40.476
10013010045,屏東縣,屏東市,頂柳里,183,190,337,126,-154,64,-45.697,50.794
10013010046,屏東縣,屏東市,大湖里,295,217,252,462,43,-245,17.063,-53.03
10013010043,屏東縣,屏東市,龍華里,312,326,304,621,8,-295,2.632,-47.504
10013010044,屏東縣,屏東市,玉成里,202,297,106,515,96,-218,90.566,-42.33
10013010035,屏東縣,屏東市,建國里,319,220,183,222,136,-2,74.317,-0.901
10013010033,屏東縣,屏東市,厚生里,441,433,420,818,21,-385,5.0,-47.066
10013010036,屏東縣,屏東市,一心里,397,242,285,275,112,-33,39.298,-12.0
10013010038,屏東縣,屏東市,義勇里,398,223,315,241,83,-18,26.349,-7.469
10013010040,屏東縣,屏東市,永安里,1136,777,1205,1699,-69,-922,-5.726,-54.267
10013010083,屏東縣,屏東市,崇陽里,1883,632,,,,,,
10013010073,屏東縣,屏東市,崇蘭里,1893,831,2892,2283,-999,-1452,-34.544,-63.601
10013010075,屏東縣,屏東市,潭墘里,1216,465,2642,1903,-1426,-1438,-53.974,-75.565
10013010066,屏東縣,屏東市,永城里,400,247,361,409,39,-162,10.803,-39.609
10013010074,屏東縣,屏東市,空翔里,988,320,523,278,465,42,88.91,15.108
10013010071,屏東縣,屏東市,廣興里,647,351,382,491,265,-140,69.372,-28.513
10013010065,屏東縣,屏東市,勝利里,1131,503,1076,945,55,-442,5.112,-46.772
10013010059,屏東縣,屏東市,斯文里,439,267,407,351,32,-84,7.862,-23.932
10013010060,屏東縣,屏東市,華山里,1084,490,1036,965,48,-475,4.633,-49.223
10013010067,屏東縣,屏東市,溝美里,424,243,444,541,-20,-298,-4.505,-55.083
10013010084,屏東縣,屏東市,公園里,395,216,,,,,,
10013010070,屏東縣,屏東市,仁愛里,414,263,465,552,-51,-289,-10.968,-52.355
10013010069,屏東縣,屏東市,北興里,1267,640,1265,1297,2,-657,0.158,-50.655
10013010068,屏東縣,屏東市,北勢里,448,306,481,607,-33,-301,-6.861,-49.588
10013010064,屏東縣,屏東市,中正里,1035,464,1020,951,15,-487,1.471,-51.209
10013010076,屏東縣,屏東市,三山里,184,188,186,385,-2,-197,-1.075,-51.169
10013010077,屏東縣,屏東市,海豐里,96,148,103,268,-7,-120,-6.796,-44.776
10013010078,屏東縣,屏東市,仁義里,154,142,133,291,21,-149,15.789,-51.203
10013010080,屏東縣,屏東市,信和里,226,252,170,516,56,-264,32.941,-51.163
10013010079,屏東縣,屏東市,和興里,171,140,127,293,44,-153,34.646,-52.218
10013020001,屏東縣,潮州鎮,潮州里,122,57,118,106,4,-49,3.39,-46.226
10013020005,屏東縣,潮州鎮,光華里,858,570,751,999,107,-429,14.248,-42.943
10013020002,屏東縣,潮州鎮,同榮里,94,98,102,198,-8,-100,-7.843,-50.505
10013020006,屏東縣,潮州鎮,彭城里,112,134,107,270,5,-136,4.673,-50.37
10013020007,屏東縣,潮州鎮,三星里,1099,765,985,1305,114,-540,11.574,-41.379
10013020008,屏東縣,潮州鎮,三共里,1261,868,1197,1567,64,-699,5.347,-44.608
10013020009,屏東縣,潮州鎮,三和里,417,244,377,504,40,-260,10.61,-51.587
10013020018,屏東縣,潮州鎮,九塊里,217,233,172,450,45,-217,26.163,-48.222
10013020004,屏東縣,潮州鎮,新生里,182,121,155,259,27,-138,17.419,-53.282
10013020003,屏東縣,潮州鎮,新榮里,236,172,217,330,19,-158,8.756,-47.879
10013020010,屏東縣,潮州鎮,五魁里,256,213,208,341,48,-128,23.077,-37.537
10013020011,屏東縣,潮州鎮,蓬萊里,406,323,325,603,81,-280,24.923,-46.434
10013020012,屏東縣,潮州鎮,八爺里,424,303,364,554,60,-251,16.484,-45.307
10013020013,屏東縣,潮州鎮,永春里,1320,840,1118,1545,202,-705,18.068,-45.631
10013020014,屏東縣,潮州鎮,富春里,188,155,186,263,2,-108,1.075,-41.065
10013020015,屏東縣,潮州鎮,光春里,246,177,207,347,39,-170,18.841,-48.991
10013020016,屏東縣,潮州鎮,興美里,115,107,104,205,11,-98,10.577,-47.805
10013020017,屏東縣,潮州鎮,檨子里,84,31,57,112,27,-81,47.368,-72.321
10013020019,屏東縣,潮州鎮,泗林里,267,213,252,444,15,-231,5.952,-52.027
10013020020,屏東縣,潮州鎮,四春里,226,247,203,480,23,-233,11.33,-48.542
10013020021,屏東縣,潮州鎮,崙東里,200,232,175,435,25,-203,14.286,-46.667
10013030001,屏東縣,東港鎮,新勝里,326,337,291,658,35,-321,12.027,-48.784
10013030003,屏東縣,東港鎮,頂中里,213,225,132,247,81,-22,61.364,-8.907
10013030025,屏東縣,東港鎮,內關帝里,450,315,,,,,,
10013030026,屏東縣,東港鎮,東新里,371,244,,,,,,
10013030027,屏東縣,東港鎮,新街里,618,474,,,,,,
10013030028,屏東縣,東港鎮,東光里,273,251,,,,,,
10013030020,屏東縣,東港鎮,興農里,231,223,190,360,41,-137,21.579,-38.056
10013030023,屏東縣,東港鎮,福德里,300,274,,,,,,
10013030007,屏東縣,東港鎮,朝安里,197,235,163,432,34,-197,20.859,-45.602
10013030009,屏東縣,東港鎮,東隆里,180,170,144,292,36,-122,25.0,-41.781
10013030010,屏東縣,東港鎮,豐漁里,187,165,74,166,113,-1,152.703,-0.602
10013030011,屏東縣,東港鎮,盛漁里,197,330,122,371,75,-41,61.475,-11.051
10013030012,屏東縣,東港鎮,興漁里,203,232,169,534,34,-302,20.118,-56.554
10013030013,屏東縣,東港鎮,鎮海里,198,282,246,800,-48,-518,-19.512,-64.75
10013030014,屏東縣,東港鎮,嘉蓮里,172,194,189,477,-17,-283,-8.995,-59.329
10013030015,屏東縣,東港鎮,南平里,232,146,199,332,33,-186,16.583,-56.024
10013030024,屏東縣,東港鎮,東津里,475,358,,,,,,
10013030016,屏東縣,東港鎮,船頭里,352,317,725,1371,-373,-1054,-51.448,-76.878
10013030017,屏東縣,東港鎮,下廍里,206,325,163,626,43,-301,26.38,-48.083
10013030018,屏東縣,東港鎮,大潭里,203,191,179,418,24,-227,13.408,-54.306
10013030021,屏東縣,東港鎮,興和里,109,183,89,330,20,-147,22.472,-44.545
10013030022,屏東縣,東港鎮,共和里,163,44,200,87,-37,-43,-18.5,-49.425
10013040001,屏東縣,恆春鎮,城南里,146,90,160,135,-14,-45,-8.75,-33.333
10013040002,屏東縣,恆春鎮,城北里,424,233,340,370,84,-137,24.706,-37.027
10013040003,屏東縣,恆春鎮,城西里,221,114,170,150,51,-36,30.0,-24.0
10013040005,屏東縣,恆春鎮,網紗里,562,303,419,474,143,-171,34.129,-36.076
10013040006,屏東縣,恆春鎮,仁壽里,137,90,91,138,46,-48,50.549,-34.783
10013040007,屏東縣,恆春鎮,茄湖里,73,71,62,106,11,-35,17.742,-33.019
10013040008,屏東縣,恆春鎮,頭溝里,48,63,60,104,-12,-41,-20.0,-39.423
10013040009,屏東縣,恆春鎮,四溝里,149,85,106,166,43,-81,40.566,-48.795
10013040010,屏東縣,恆春鎮,德和里,154,127,99,148,55,-21,55.556,-14.189
10013040011,屏東縣,恆春鎮,龍水里,168,94,134,151,34,-57,25.373,-37.748
10013040012,屏東縣,恆春鎮,山海里,155,199,146,339,9,-140,6.164,-41.298
10013040013,屏東縣,恆春鎮,大光里,285,201,269,263,16,-62,5.948,-23.574
10013040014,屏東縣,恆春鎮,水泉里,195,133,105,215,90,-82,85.714,-38.14
10013040004,屏東縣,恆春鎮,山腳里,753,416,617,578,136,-162,22.042,-28.028
10013040015,屏東縣,恆春鎮,南灣里,280,177,254,229,26,-52,10.236,-22.707
10013040016,屏東縣,恆春鎮,墾丁里,201,168,201,256,0,-88,0.0,-34.375
10013040017,屏東縣,恆春鎮,鵝鑾里,152,94,163,171,-11,-77,-6.748,-45.029
10013050023,屏東縣,萬丹鄉,香社村,223,220,210,415,13,-195,6.19,-46.988
10013050022,屏東縣,萬丹鄉,新庄村,339,309,338,533,1,-224,0.296,-42.026
10013050025,屏東縣,萬丹鄉,新鐘村,354,227,332,396,22,-169,6.627,-42.677
10013050029,屏東縣,萬丹鄉,水仙村,109,67,93,139,16,-72,17.204,-51.799
10013050027,屏東縣,萬丹鄉,興全村,190,161,160,314,30,-153,18.75,-48.726
10013050028,屏東縣,萬丹鄉,興安村,113,164,96,258,17,-94,17.708,-36.434
10013050030,屏東縣,萬丹鄉,甘棠村,66,51,50,81,16,-30,32.0,-37.037
10013050002,屏東縣,萬丹鄉,萬惠村,173,131,127,235,46,-104,36.22,-44.255
10013050003,屏東縣,萬丹鄉,萬全村,567,468,516,946,51,-478,9.884,-50.529
10013050004,屏東縣,萬丹鄉,萬後村,118,107,78,161,40,-54,51.282,-33.54
10013050001,屏東縣,萬丹鄉,萬安村,89,87,75,170,14,-83,18.667,-48.824
10013050005,屏東縣,萬丹鄉,萬生村,273,152,242,363,31,-211,12.81,-58.127
10013050006,屏東縣,萬丹鄉,寶厝村,410,284,352,506,58,-222,16.477,-43.874
10013050007,屏東縣,萬丹鄉,四維村,320,292,270,559,50,-267,18.519,-47.764
10013050008,屏東縣,萬丹鄉,竹林村,270,209,214,480,56,-271,26.168,-56.458
10013050021,屏東縣,萬丹鄉,水泉村,325,330,280,490,45,-160,16.071,-32.653
10013050010,屏東縣,萬丹鄉,田厝村,150,220,115,328,35,-108,30.435,-32.927
10013050011,屏東縣,萬丹鄉,崙頂村,296,277,204,511,92,-234,45.098,-45.793
10013050012,屏東縣,萬丹鄉,厦北村,235,284,191,494,44,-210,23.037,-42.51
10013050013,屏東縣,萬丹鄉,厦南村,230,201,186,379,44,-178,23.656,-46.966
10013050024,屏東縣,萬丹鄉,後村村,161,166,131,319,30,-153,22.901,-47.962
10013050026,屏東縣,萬丹鄉,灣內村,144,215,139,390,5,-175,3.597,-44.872
10013050014,屏東縣,萬丹鄉,上村村,130,123,97,267,33,-144,34.021,-53.933
10013050015,屏東縣,萬丹鄉,加興村,161,221,117,423,44,-202,37.607,-47.754
10013050016,屏東縣,萬丹鄉,社口村,273,229,194,362,79,-133,40.722,-36.74
10013050017,屏東縣,萬丹鄉,磚寮村,160,159,130,287,30,-128,23.077,-44.599
10013050018,屏東縣,萬丹鄉,社皮村,363,283,256,585,107,-302,41.797,-51.624
10013050020,屏東縣,萬丹鄉,社中村,237,259,192,521,45,-262,23.438,-50.288
10013050019,屏東縣,萬丹鄉,社上村,278,239,213,498,65,-259,30.516,-52.008
10013050009,屏東縣,萬丹鄉,廣安村,389,350,324,695,65,-345,20.062,-49.64
10013060001,屏東縣,長治鄉,進興村,491,312,493,614,-2,-302,-0.406,-49.186
10013060002,屏東縣,長治鄉,新潭村,843,454,686,823,157,-369,22.886,-44.836
10013060003,屏東縣,長治鄉,潭頭村,401,266,369,520,32,-254,8.672,-48.846
10013060004,屏東縣,長治鄉,香楊村,566,357,483,686,83,-329,17.184,-47.959
10013060005,屏東縣,長治鄉,長興村,253,131,214,264,39,-133,18.224,-50.379
10013060009,屏東縣,長治鄉,崙上村,297,250,296,406,1,-156,0.338,-38.424
10013060010,屏東縣,長治鄉,德榮村,205,172,152,371,53,-199,34.868,-53.639
10013060011,屏東縣,長治鄉,德和村,105,127,73,196,32,-69,43.836,-35.204
10013060008,屏東縣,長治鄉,復興村,247,194,235,429,12,-235,5.106,-54.779
10013060006,屏東縣,長治鄉,德成村,170,129,160,247,10,-118,6.25,-47.773
10013060007,屏東縣,長治鄉,德協村,190,144,157,314,33,-170,21.019,-54.14
10013060013,屏東縣,長治鄉,繁昌村,229,181,191,475,38,-294,19.895,-61.895
10013060014,屏東縣,長治鄉,繁榮村,193,147,152,329,41,-182,26.974,-55.319
10013060015,屏東縣,長治鄉,繁隆村,177,114,147,252,30,-138,20.408,-54.762
10013060012,屏東縣,長治鄉,繁華村,293,284,229,693,64,-409,27.948,-59.019
10013060016,屏東縣,長治鄉,榮華村,200,45,183,121,17,-76,9.29,-62.81
10013070001,屏東縣,麟洛鄉,新田村,446,362,328,675,118,-313,35.976,-46.37
10013070002,屏東縣,麟洛鄉,麟頂村,204,193,159,277,45,-84,28.302,-30.325
10013070003,屏東縣,麟洛鄉,麟蹄村,277,322,254,484,23,-162,9.055,-33.471
10013070004,屏東縣,麟洛鄉,麟趾村,443,449,398,778,45,-329,11.307,-42.288
10013070005,屏東縣,麟洛鄉,田中村,193,228,168,390,25,-162,14.881,-41.538
10013070006,屏東縣,麟洛鄉,田心村,173,152,162,258,11,-106,6.79,-41.085
10013070007,屏東縣,麟洛鄉,田道村,132,122,111,236,21,-114,18.919,-48.305
10013080001,屏東縣,九如鄉,九清村,189,254,156,440,33,-186,21.154,-42.273
10013080002,屏東縣,九如鄉,九塊村,167,204,155,434,12,-230,7.742,-52.995
10013080003,屏東縣,九如鄉,九明村,297,328,190,602,107,-274,56.316,-45.515
10013080005,屏東縣,九如鄉,大坵村,221,164,145,328,76,-164,52.414,-50.0
10013080004,屏東縣,九如鄉,玉水村,173,205,142,369,31,-164,21.831,-44.444
10013080011,屏東縣,九如鄉,玉泉村,262,267,240,469,22,-202,9.167,-43.07
10013080010,屏東縣,九如鄉,東寧村,776,668,618,1391,158,-723,25.566,-51.977
10013080006,屏東縣,九如鄉,三塊村,216,224,152,460,64,-236,42.105,-51.304
10013080008,屏東縣,九如鄉,耆老村,175,204,139,398,36,-194,25.899,-48.744
10013080007,屏東縣,九如鄉,後庄村,254,275,163,637,91,-362,55.828,-56.829
10013080009,屏東縣,九如鄉,洽興村,242,237,181,435,61,-198,33.702,-45.517
10013090001,屏東縣,里港鄉,玉田村,520,464,400,908,120,-444,30.0,-48.899
10013090007,屏東縣,里港鄉,塔樓村,225,284,173,464,52,-180,30.058,-38.793
10013090008,屏東縣,里港鄉,潮厝村,198,227,154,440,44,-213,28.571,-48.409
10013090002,屏東縣,里港鄉,大平村,202,141,165,308,37,-167,22.424,-54.221
10013090003,屏東縣,里港鄉,永春村,146,125,93,249,53,-124,56.989,-49.799
10013090004,屏東縣,里港鄉,春林村,213,191,185,392,28,-201,15.135,-51.276
10013090005,屏東縣,里港鄉,過江村,306,249,240,582,66,-333,27.5,-57.216
10013090006,屏東縣,里港鄉,鐵店村,219,191,176,423,43,-232,24.432,-54.846
10013090009,屏東縣,里港鄉,茄苳村,192,253,160,495,32,-242,20.0,-48.889
10013090010,屏東縣,里港鄉,載興村,319,399,226,766,93,-367,41.15,-47.911
10013090011,屏東縣,里港鄉,土庫村,453,224,370,475,83,-251,22.432,-52.842
10013090012,屏東縣,里港鄉,三廍村,343,197,245,477,98,-280,40.0,-58.7
10013090013,屏東縣,里港鄉,中和村,140,110,128,222,12,-112,9.375,-50.45
10013090014,屏東縣,里港鄉,瀰力村,81,159,60,197,21,-38,35.0,-19.289
10013100003,屏東縣,鹽埔鄉,鹽北村,279,129,259,321,20,-192,7.722,-59.813
10013100004,屏東縣,鹽埔鄉,鹽中村,383,184,359,425,24,-241,6.685,-56.706
10013100005,屏東縣,鹽埔鄉,鹽南村,315,133,258,297,57,-164,22.093,-55.219
10013100006,屏東縣,鹽埔鄉,仕絨村,193,75,187,165,6,-90,3.209,-54.545
10013100002,屏東縣,鹽埔鄉,高朗村,417,275,279,625,138,-350,49.462,-56.0
10013100007,屏東縣,鹽埔鄉,振興村,259,201,229,379,30,-178,13.1,-46.966
10013100009,屏東縣,鹽埔鄉,久愛村,145,99,146,199,-1,-100,-0.685,-50.251
10013100001,屏東縣,鹽埔鄉,新圍村,396,330,322,752,74,-422,22.981,-56.117
10013100011,屏東縣,鹽埔鄉,新二村,615,317,523,722,92,-405,17.591,-56.094
10013100012,屏東縣,鹽埔鄉,彭厝村,170,103,156,225,14,-122,8.974,-54.222
10013100010,屏東縣,鹽埔鄉,洛陽村,269,203,247,393,22,-190,8.907,-48.346
10013100008,屏東縣,鹽埔鄉,永隆村,74,76,63,150,11,-74,17.46,-49.333
10013110001,屏東縣,高樹鄉,高樹村,248,371,230,730,18,-359,7.826,-49.178
10013110002,屏東縣,高樹鄉,長榮村,141,231,121,415,20,-184,16.529,-44.337
10013110003,屏東縣,高樹鄉,東興村,76,116,70,260,6,-144,8.571,-55.385
10013110004,屏東縣,高樹鄉,東振村,67,103,57,182,10,-79,17.544,-43.407
10013110005,屏東縣,高樹鄉,源泉村,139,167,117,323,22,-156,18.803,-48.297
10013110006,屏東縣,高樹鄉,建興村,124,177,91,346,33,-169,36.264,-48.844
10013110007,屏東縣,高樹鄉,大埔村,85,82,68,185,17,-103,25.0,-55.676
10013110008,屏東縣,高樹鄉,菜寮村,59,165,53,257,6,-92,11.321,-35.798
10013110009,屏東縣,高樹鄉,司馬村,90,70,68,144,22,-74,32.353,-51.389
10013110010,屏東縣,高樹鄉,舊寮村,132,165,129,353,3,-188,2.326,-53.258
10013110011,屏東縣,高樹鄉,新豐村,147,205,132,373,15,-168,11.364,-45.04
10013110012,屏東縣,高樹鄉,泰山村,234,241,197,459,37,-218,18.782,-47.495
10013110013,屏東縣,高樹鄉,南華村,166,182,131,331,35,-149,26.718,-45.015
10013110014,屏東縣,高樹鄉,廣福村,135,175,119,318,16,-143,13.445,-44.969
10013110015,屏東縣,高樹鄉,廣興村,146,113,110,249,36,-136,32.727,-54.618
10013110016,屏東縣,高樹鄉,舊庄村,122,186,99,297,23,-111,23.232,-37.374
10013110017,屏東縣,高樹鄉,田子村,158,155,102,309,56,-154,54.902,-49.838
10013110018,屏東縣,高樹鄉,鹽樹村,178,232,148,390,30,-158,20.27,-40.513
10013110019,屏東縣,高樹鄉,新南村,167,192,141,404,26,-212,18.44,-52.475
10013120001,屏東縣,萬巒鄉,萬巒村,154,194,141,366,13,-172,9.22,-46.995
10013120002,屏東縣,萬巒鄉,萬全村,112,122,99,213,13,-91,13.131,-42.723
10013120003,屏東縣,萬巒鄉,萬和村,235,290,241,526,-6,-236,-2.49,-44.867
10013120004,屏東縣,萬巒鄉,鹿寮村,137,160,114,293,23,-133,20.175,-45.392
10013120005,屏東縣,萬巒鄉,硫黃村,73,89,67,206,6,-117,8.955,-56.796
10013120006,屏東縣,萬巒鄉,泗溝村,159,153,178,307,-19,-154,-10.674,-50.163
10013120007,屏東縣,萬巒鄉,五溝村,160,147,158,319,2,-172,1.266,-53.918
10013120008,屏東縣,萬巒鄉,成德村,200,220,195,385,5,-165,2.564,-42.857
10013120010,屏東縣,萬巒鄉,赤山村,213,177,195,368,18,-191,9.231,-51.902
10013120009,屏東縣,萬巒鄉,萬金村,244,278,204,581,40,-303,19.608,-52.151
10013120011,屏東縣,萬巒鄉,佳佐村,209,271,138,484,71,-213,51.449,-44.008
10013120012,屏東縣,萬巒鄉,佳和村,232,125,190,340,42,-215,22.105,-63.235
10013120013,屏東縣,萬巒鄉,新厝村,138,156,106,369,32,-213,30.189,-57.724
10013120014,屏東縣,萬巒鄉,新置村,158,156,148,275,10,-119,6.757,-43.273
10013130001,屏東縣,內埔鄉,內埔村,703,517,649,974,54,-457,8.32,-46.92
10013130002,屏東縣,內埔鄉,內田村,605,442,474,813,131,-371,27.637,-45.633
10013130006,屏東縣,內埔鄉,和興村,573,399,454,688,119,-289,26.211,-42.006
10013130005,屏東縣,內埔鄉,美和村,379,335,341,585,38,-250,11.144,-42.735
10013130003,屏東縣,內埔鄉,興南村,201,211,210,386,-9,-175,-4.286,-45.337
10013130004,屏東縣,內埔鄉,義亭村,94,105,79,168,15,-63,18.987,-37.5
10013130007,屏東縣,內埔鄉,東寧村,856,667,693,1186,163,-519,23.521,-43.761
10013130008,屏東縣,內埔鄉,豐田村,600,414,447,801,153,-387,34.228,-48.315
10013130009,屏東縣,內埔鄉,振豐村,273,242,259,508,14,-266,5.405,-52.362
10013130010,屏東縣,內埔鄉,富田村,270,288,220,607,50,-319,22.727,-52.554
10013130011,屏東縣,內埔鄉,竹圍村,275,260,256,540,19,-280,7.422,-51.852
10013130012,屏東縣,內埔鄉,東勢村,366,444,349,842,17,-398,4.871,-47.268
10013130013,屏東縣,內埔鄉,東片村,116,210,140,339,-24,-129,-17.143,-38.053
10013130014,屏東縣,內埔鄉,上樹村,156,182,146,351,10,-169,6.849,-48.148
10013130015,屏東縣,內埔鄉,老埤村,261,274,228,525,33,-251,14.474,-47.81
10013130016,屏東縣,內埔鄉,中林村,206,234,126,428,80,-194,63.492,-45.327
10013130017,屏東縣,內埔鄉,龍泉村,457,219,396,489,61,-270,15.404,-55.215
10013130018,屏東縣,內埔鄉,龍潭村,460,184,400,368,60,-184,15.0,-50.0
10013130019,屏東縣,內埔鄉,建興村,141,100,139,223,2,-123,1.439,-55.157
10013130020,屏東縣,內埔鄉,大新村,293,228,270,432,23,-204,8.519,-47.222
10013130021,屏東縣,內埔鄉,黎明村,316,259,233,605,83,-346,35.622,-57.19
10013130022,屏東縣,內埔鄉,隘寮村,162,125,144,267,18,-142,12.5,-53.184
10013130023,屏東縣,內埔鄉,水門村,175,96,143,187,32,-91,22.378,-48.663
10013140001,屏東縣,竹田鄉,竹田村,223,276,232,430,-9,-154,-3.879,-35.814
10013140002,屏東縣,竹田鄉,竹南村,135,168,106,302,29,-134,27.358,-44.371
10013140003,屏東縣,竹田鄉,糶糴村,114,121,113,221,1,-100,0.885,-45.249
10013140004,屏東縣,竹田鄉,履豐村,107,121,88,189,19,-68,21.591,-35.979
10013140005,屏東縣,竹田鄉,頭崙村,222,219,167,407,55,-188,32.934,-46.192
10013140006,屏東縣,竹田鄉,二崙村,160,192,154,319,6,-127,3.896,-39.812
10013140007,屏東縣,竹田鄉,美崙村,120,133,114,200,6,-67,5.263,-33.5
10013140008,屏東縣,竹田鄉,南勢村,67,100,73,179,-6,-79,-8.219,-44.134
10013140009,屏東縣,竹田鄉,西勢村,442,348,400,697,42,-349,10.5,-50.072
10013140010,屏東縣,竹田鄉,福田村,86,91,77,161,9,-70,11.688,-43.478
10013140011,屏東縣,竹田鄉,永豐村,131,124,125,227,6,-103,4.8,-45.374
10013140012,屏東縣,竹田鄉,六巷村,132,137,117,243,15,-106,12.821,-43.621
10013140013,屏東縣,竹田鄉,泗洲村,165,128,159,270,6,-142,3.774,-52.593
10013140014,屏東縣,竹田鄉,大湖村,184,194,154,347,30,-153,19.481,-44.092
10013140015,屏東縣,竹田鄉,鳳明村,211,133,197,262,14,-129,7.107,-49.237
10013150001,屏東縣,新埤鄉,新埤村,389,243,372,458,17,-215,4.57,-46.943
10013150002,屏東縣,新埤鄉,建功村,216,172,197,332,19,-160,9.645,-48.193
10013150003,屏東縣,新埤鄉,打鐵村,171,97,162,217,9,-120,5.556,-55.3
10013150004,屏東縣,新埤鄉,南豐村,100,118,107,234,-7,-116,-6.542,-49.573
10013150005,屏東縣,新埤鄉,萬隆村,288,202,243,323,45,-121,18.519,-37.461
10013150007,屏東縣,新埤鄉,餉潭村,120,155,95,270,25,-115,26.316,-42.593
10013150006,屏東縣,新埤鄉,箕湖村,148,132,124,233,24,-101,19.355,-43.348
10013160001,屏東縣,枋寮鄉,枋寮村,227,93,221,240,6,-147,2.715,-61.25
10013160002,屏東縣,枋寮鄉,新龍村,157,65,183,140,-26,-75,-14.208,-53.571
10013160003,屏東縣,枋寮鄉,保生村,111,128,110,242,1,-114,0.909,-47.107
10013160004,屏東縣,枋寮鄉,中寮村,82,92,76,173,6,-81,7.895,-46.821
10013160005,屏東縣,枋寮鄉,安樂村,229,200,208,406,21,-206,10.096,-50.739
10013160006,屏東縣,枋寮鄉,隆山村,645,507,453,1077,192,-570,42.384,-52.925
10013160007,屏東縣,枋寮鄉,天時村,290,281,259,542,31,-261,11.969,-48.155
10013160008,屏東縣,枋寮鄉,地利村,234,245,244,409,-10,-164,-4.098,-40.098
10013160009,屏東縣,枋寮鄉,人和村,373,294,308,519,65,-225,21.104,-43.353
10013160010,屏東縣,枋寮鄉,內寮村,57,108,64,186,-7,-78,-10.938,-41.935
10013160011,屏東縣,枋寮鄉,新開村,101,78,90,145,11,-67,12.222,-46.207
10013160014,屏東縣,枋寮鄉,東海村,517,318,426,588,91,-270,21.362,-45.918
10013160015,屏東縣,枋寮鄉,大庄村,95,101,79,154,16,-53,20.253,-34.416
10013160012,屏東縣,枋寮鄉,太源村,147,74,127,163,20,-89,15.748,-54.601
10013160013,屏東縣,枋寮鄉,玉泉村,68,43,57,63,11,-20,19.298,-31.746
10013170001,屏東縣,新園鄉,瓦磘村,239,224,162,507,77,-283,47.531,-55.819
10013170002,屏東縣,新園鄉,仙吉村,327,317,272,639,55,-322,20.221,-50.391
10013170003,屏東縣,新園鄉,田洋村,274,271,216,602,58,-331,26.852,-54.983
10013170004,屏東縣,新園鄉,港墘村,123,102,109,197,14,-95,12.844,-48.223
10013170005,屏東縣,新園鄉,內庄村,119,114,122,240,-3,-126,-2.459,-52.5
10013170006,屏東縣,新園鄉,新東村,362,269,299,527,63,-258,21.07,-48.956
10013170007,屏東縣,新園鄉,新園村,308,264,314,564,-6,-300,-1.911,-53.191
10013170012,屏東縣,新園鄉,港西村,259,238,254,543,5,-305,1.969,-56.169
10013170008,屏東縣,新園鄉,烏龍村,136,163,143,358,-7,-195,-4.895,-54.469
10013170009,屏東縣,新園鄉,興龍村,264,332,217,684,47,-352,21.659,-51.462
10013170010,屏東縣,新園鄉,中洲村,162,285,110,530,52,-245,47.273,-46.226
10013170011,屏東縣,新園鄉,南龍村,153,206,136,430,17,-224,12.5,-52.093
10013170013,屏東縣,新園鄉,五房村,387,398,340,715,47,-317,13.824,-44.336
10013170014,屏東縣,新園鄉,鹽埔村,456,673,373,1238,83,-565,22.252,-45.638
10013170015,屏東縣,新園鄉,共和村,205,320,152,623,53,-303,34.868,-48.636
10013180001,屏東縣,崁頂鄉,崁頂村,332,282,295,548,37,-266,12.542,-48.54
10013180002,屏東縣,崁頂鄉,園寮村,324,302,304,490,20,-188,6.579,-38.367
10013180004,屏東縣,崁頂鄉,力社村,157,207,136,368,21,-161,15.441,-43.75
10013180003,屏東縣,崁頂鄉,圍內村,192,161,172,320,20,-159,11.628,-49.688
10013180005,屏東縣,崁頂鄉,洲子村,121,173,112,257,9,-84,8.036,-32.685
10013180006,屏東縣,崁頂鄉,北勢村,177,229,189,420,-12,-191,-6.349,-45.476
10013180007,屏東縣,崁頂鄉,越溪村,130,108,117,239,13,-131,11.111,-54.812
10013180008,屏東縣,崁頂鄉,港東村,215,268,179,542,36,-274,20.112,-50.554
10013190001,屏東縣,林邊鄉,林邊村,195,256,191,432,4,-176,2.094,-40.741
10013190002,屏東縣,林邊鄉,光林村,211,238,187,435,24,-197,12.834,-45.287
10013190005,屏東縣,林邊鄉,永樂村,444,570,415,960,29,-390,6.988,-40.625
10013190004,屏東縣,林邊鄉,中林村,127,100,121,200,6,-100,4.959,-50.0
10013190003,屏東縣,林邊鄉,仁和村,235,279,211,479,24,-200,11.374,-41.754
10013190008,屏東縣,林邊鄉,田厝村,116,139,106,247,10,-108,9.434,-43.725
10013190007,屏東縣,林邊鄉,崎峯村,162,166,150,283,12,-117,8.0,-41.343
10013190006,屏東縣,林邊鄉,水利村,279,240,241,400,38,-160,15.768,-40.0
10013190009,屏東縣,林邊鄉,竹林村,260,253,213,546,47,-293,22.066,-53.663
10013190010,屏東縣,林邊鄉,鎮安村,174,179,144,319,30,-140,20.833,-43.887
10013200001,屏東縣,南州鄉,溪洲村,254,226,229,462,25,-236,10.917,-51.082
10013200002,屏東縣,南州鄉,溪南村,128,149,140,255,-12,-106,-8.571,-41.569
10013200005,屏東縣,南州鄉,七塊村,127,118,126,240,1,-122,0.794,-50.833
10013200006,屏東縣,南州鄉,萬華村,153,123,133,229,20,-106,15.038,-46.288
10013200003,屏東縣,南州鄉,仁里村,83,81,86,135,-3,-54,-3.488,-40.0
10013200004,屏東縣,南州鄉,溪北村,183,73,182,128,1,-55,0.549,-42.969
10013200007,屏東縣,南州鄉,米崙村,145,148,165,290,-20,-142,-12.121,-48.966
10013200008,屏東縣,南州鄉,壽元村,87,193,70,354,17,-161,24.286,-45.48
10013200009,屏東縣,南州鄉,同安村,112,164,96,326,16,-162,16.667,-49.693
10013200010,屏東縣,南州鄉,南安村,53,110,60,177,-7,-67,-11.667,-37.853
10013210001,屏東縣,佳冬鄉,佳冬村,241,191,210,376,31,-185,14.762,-49.202
10013210002,屏東縣,佳冬鄉,六根村,179,206,193,347,-14,-141,-7.254,-40.634
10013210003,屏東縣,佳冬鄉,賴家村,99,134,96,248,3,-114,3.125,-45.968
10013210004,屏東縣,佳冬鄉,萬建村,275,219,235,457,40,-238,17.021,-52.079
10013210005,屏東縣,佳冬鄉,石光村,211,306,205,595,6,-289,2.927,-48.571
10013210006,屏東縣,佳冬鄉,玉光村,268,309,193,598,75,-289,38.86,-48.328
10013210007,屏東縣,佳冬鄉,昌隆村,145,130,118,283,27,-153,22.881,-54.064
10013210008,屏東縣,佳冬鄉,豐隆村,85,68,86,184,-1,-116,-1.163,-63.043
10013210009,屏東縣,佳冬鄉,大同村,158,157,119,329,39,-172,32.773,-52.28
10013210010,屏東縣,佳冬鄉,羌園村,137,166,99,314,38,-148,38.384,-47.134
10013210011,屏東縣,佳冬鄉,燄溫村,166,98,124,232,42,-134,33.871,-57.759
10013210012,屏東縣,佳冬鄉,塭豐村,313,263,317,460,-4,-197,-1.262,-42.826
10013220001,屏東縣,琉球鄉,本福村,229,102,243,257,-14,-155,-5.761,-60.311
10013220002,屏東縣,琉球鄉,中福村,159,93,133,138,26,-45,19.549,-32.609
10013220003,屏東縣,琉球鄉,漁福村,144,20,159,66,-15,-46,-9.434,-69.697
10013220004,屏東縣,琉球鄉,大福村,209,56,175,116,34,-60,19.429,-51.724
10013220005,屏東縣,琉球鄉,南福村,101,55,104,89,-3,-34,-2.885,-38.202
10013220006,屏東縣,琉球鄉,天福村,106,87,108,89,-2,-2,-1.852,-2.247
10013220007,屏東縣,琉球鄉,上福村,199,63,147,113,52,-50,35.374,-44.248
10013220008,屏東縣,琉球鄉,杉福村,121,46,84,84,37,-38,44.048,-45.238
10013230004,屏東縣,車城鄉,海口村,101,78,87,114,14,-36,16.092,-31.579
10013230003,屏東縣,車城鄉,田中村,79,70,60,98,19,-28,31.667,-28.571
10013230002,屏東縣,車城鄉,福安村,83,98,58,167,25,-69,43.103,-41.317
10013230001,屏東縣,車城鄉,福興村,231,159,215,269,16,-110,7.442,-40.892
10013230005,屏東縣,車城鄉,統埔村,57,38,43,68,14,-30,32.558,-44.118
10013230006,屏東縣,車城鄉,溫泉村,130,85,109,160,21,-75,19.266,-46.875
10013230007,屏東縣,車城鄉,保力村,191,147,145,206,46,-59,31.724,-28.641
10013230008,屏東縣,車城鄉,新街村,45,68,36,112,9,-44,25.0,-39.286
10013230009,屏東縣,車城鄉,埔墘村,74,31,55,56,19,-25,34.545,-44.643
10013230010,屏東縣,車城鄉,射寮村,60,61,74,78,-14,-17,-18.919,-21.795
10013230011,屏東縣,車城鄉,後灣村,55,46,67,88,-12,-42,-17.91,-47.727
10013240001,屏東縣,滿州鄉,滿州村,205,120,199,220,6,-100,3.015,-45.455
10013240002,屏東縣,滿州鄉,里德村,49,23,61,57,-12,-34,-19.672,-59.649
10013240005,屏東縣,滿州鄉,响林村,58,88,51,97,7,-9,13.725,-9.278
10013240003,屏東縣,滿州鄉,永靖村,175,140,168,202,7,-62,4.167,-30.693
10013240004,屏東縣,滿州鄉,港口村,156,156,135,256,21,-100,15.556,-39.062
10013240006,屏東縣,滿州鄉,長樂村,144,87,137,130,7,-43,5.109,-33.077
10013240007,屏東縣,滿州鄉,九棚村,62,38,41,49,21,-11,51.22,-22.449
10013240008,屏東縣,滿州鄉,港仔村,47,30,46,51,1,-21,2.174,-41.176
10013250001,屏東縣,枋山鄉,枋山村,181,102,170,183,11,-81,6.471,-44.262
10013250002,屏東縣,枋山鄉,加祿村,273,236,224,467,49,-231,21.875,-49.465
10013250003,屏東縣,枋山鄉,楓港村,93,104,70,221,23,-117,32.857,-52.941
10013250004,屏東縣,枋山鄉,善餘村,76,82,76,172,0,-90,0.0,-52.326
10013260004,屏東縣,三地門鄉,大社村,179,36,146,29,33,7,22.603,24.138
10013260003,屏東縣,三地門鄉,德文村,57,17,56,31,1,-14,1.786,-45.161
10013260002,屏東縣,三地門鄉,達來村,51,60,59,36,-8,24,-13.559,66.667
10013260001,屏東縣,三地門鄉,三地村,373,90,432,124,-59,-34,-13.657,-27.419
10013260005,屏東縣,三地門鄉,賽嘉村,136,58,158,60,-22,-2,-13.924,-3.333
10013260006,屏東縣,三地門鄉,口社村,142,58,137,51,5,7,3.65,13.725
10013260007,屏東縣,三地門鄉,馬兒村,55,16,66,34,-11,-18,-16.667,-52.941
10013260008,屏東縣,三地門鄉,安坡村,105,33,112,42,-7,-9,-6.25,-21.429
10013260009,屏東縣,三地門鄉,青山村,174,23,163,36,11,-13,6.748,-36.111
10013260010,屏東縣,三地門鄉,青葉村,151,48,132,35,19,13,14.394,37.143
10013270001,屏東縣,霧臺鄉,霧台村,251,112,233,115,18,-3,7.725,-2.609
10013270003,屏東縣,霧臺鄉,吉露村,68,15,56,16,12,-1,21.429,-6.25
10013270002,屏東縣,霧臺鄉,阿禮村,82,34,87,18,-5,16,-5.747,88.889
10013270006,屏東縣,霧臺鄉,好茶村,136,68,110,75,26,-7,23.636,-9.333
10013270005,屏東縣,霧臺鄉,佳暮村,87,33,126,22,-39,11,-30.952,50.0
10013270004,屏東縣,霧臺鄉,大武村,59,31,40,25,19,6,47.5,24.0
10013280001,屏東縣,瑪家鄉,瑪家村,125,49,115,46,10,3,8.696,6.522
10013280002,屏東縣,瑪家鄉,北葉村,216,56,237,74,-21,-18,-8.861,-24.324
10013280003,屏東縣,瑪家鄉,凉山村,268,43,220,62,48,-19,21.818,-30.645
10013280004,屏東縣,瑪家鄉,佳義村,179,107,206,102,-27,5,-13.107,4.902
10013280005,屏東縣,瑪家鄉,排灣村,91,41,109,26,-18,15,-16.514,57.692
10013290001,屏東縣,泰武鄉,佳平村,257,63,268,56,-11,7,-4.104,12.5
10013290002,屏東縣,泰武鄉,武潭村,236,70,258,77,-22,-7,-8.527,-9.091
10013290003,屏東縣,泰武鄉,平和村,128,92,117,95,11,-3,9.402,-3.158
10013290006,屏東縣,泰武鄉,萬安村,239,32,224,31,15,1,6.696,3.226
10013290004,屏東縣,泰武鄉,佳興村,91,23,93,22,-2,1,-2.151,4.545
10013290005,屏東縣,泰武鄉,泰武村,176,36,176,31,0,5,0.0,16.129
10013300001,屏東縣,來義鄉,來義村,154,69,209,48,-55,21,-26.316,43.75
10013300002,屏東縣,來義鄉,義林村,133,62,149,46,-16,16,-10.738,34.783
10013300003,屏東縣,來義鄉,丹林村,223,48,222,38,1,10,0.45,26.316
10013300004,屏東縣,來義鄉,古樓村,290,86,338,67,-48,19,-14.201,28.358
10013300005,屏東縣,來義鄉,文樂村,222,53,243,56,-21,-3,-8.642,-5.357
10013300006,屏東縣,來義鄉,望嘉村,256,49,309,41,-53,8,-17.152,19.512
10013300007,屏東縣,來義鄉,南和村,287,86,333,78,-46,8,-13.814,10.256
10013310001,屏東縣,春日鄉,春日村,154,38,147,44,7,-6,4.762,-13.636
10013310002,屏東縣,春日鄉,古華村,154,47,138,47,16,0,11.594,0.0
10013310003,屏東縣,春日鄉,士文村,48,26,38,18,10,8,26.316,44.444
10013310004,屏東縣,春日鄉,七佳村,198,49,218,63,-20,-14,-9.174,-22.222
10013310005,屏東縣,春日鄉,歸崇村,132,35,131,40,1,-5,0.763,-12.5
10013310006,屏東縣,春日鄉,力里村,98,29,91,35,7,-6,7.692,-17.143
10013320004,屏東縣,獅子鄉,內文村,48,14,58,15,-10,-1,-17.241,-6.667
10013320003,屏東縣,獅子鄉,草埔村,179,21,183,31,-4,-10,-2.186,-32.258
10013320002,屏東縣,獅子鄉,丹路村,183,30,168,33,15,-3,8.929,-9.091
10013320001,屏東縣,獅子鄉,楓林村,206,31,172,49,34,-18,19.767,-36.735
10013320005,屏東縣,獅子鄉,竹坑村,93,11,72,23,21,-12,29.167,-52.174
10013320006,屏東縣,獅子鄉,獅子村,96,27,119,27,-23,0,-19.328,0.0
10013320007,屏東縣,獅子鄉,內獅村,195,22,179,40,16,-18,8.939,-45.0
10013320008,屏東縣,獅子鄉,南世村,91,31,93,21,-2,10,-2.151,47.619
10013330001,屏東縣,牡丹鄉,石門村,451,97,395,105,56,-8,14.177,-7.619
10013330002,屏東縣,牡丹鄉,牡丹村,188,25,193,31,-5,-6,-2.591,-19.355
10013330003,屏東縣,牡丹鄉,東源村,115,28,124,21,-9,7,-7.258,33.333
10013330004,屏東縣,牡丹鄉,旭海村,92,28,95,33,-3,-5,-3.158,-15.152
10013330005,屏東縣,牡丹鄉,高士村,128,29,118,33,10,-4,8.475,-12.121
10013330006,屏東縣,牡丹鄉,四林村,132,12,71,34,61,-22,85.915,-64.706
10018010011,新竹市,東區,育賢里,212,58,260,197,-48,-139,-18.462,-70.558
10018010017,新竹市,東區,親仁里,477,86,235,191,242,-105,102.979,-54.974
10018010006,新竹市,東區,榮光里,43,35,235,191,-192,-156,-81.702,-81.675
10018010005,新竹市,東區,東門里,89,52,99,176,-10,-124,-10.101,-70.455
10018010007,新竹市,東區,成功里,122,47,118,161,4,-114,3.39,-70.807
10018010012,新竹市,東區,中正里,113,37,107,134,6,-97,5.607,-72.388
10018010051,新竹市,東區,錦華里,476,99,497,350,-21,-251,-4.225,-71.714
10018010018,新竹市,東區,文華里,1150,311,1117,902,33,-591,2.954,-65.521
10018010019,新竹市,東區,復中里,962,269,1053,845,-91,-576,-8.642,-68.166
10018010050,新竹市,東區,復興里,1194,246,1154,996,40,-750,3.466,-75.301
10018010020,新竹市,東區,三民里,1081,314,1051,1015,30,-701,2.854,-69.064
10018010021,新竹市,東區,東園里,1462,360,1355,1308,107,-948,7.897,-72.477
10018010013,新竹市,東區,公園里,857,153,822,600,35,-447,4.258,-74.5
10018010048,新竹市,東區,建華里,571,183,550,507,21,-324,3.818,-63.905
10018010027,新竹市,東區,東山里,820,160,906,632,-86,-472,-9.492,-74.684
10018010026,新竹市,東區,綠水里,1572,374,1620,1248,-48,-874,-2.963,-70.032
10018010022,新竹市,東區,東勢里,1095,260,731,717,364,-457,49.795,-63.738
10018010023,新竹市,東區,光復里,680,188,643,674,37,-486,5.754,-72.107
10018010038,新竹市,東區,前溪里,561,161,541,595,20,-434,3.697,-72.941
10018010039,新竹市,東區,水源里,755,239,628,804,127,-565,20.223,-70.274
10018010040,新竹市,東區,千甲里,550,101,489,392,61,-291,12.474,-74.235
10018010024,新竹市,東區,豐功里,1301,291,1337,946,-36,-655,-2.693,-69.239
10018010025,新竹市,東區,武功里,1409,143,1531,511,-122,-368,-7.969,-72.016
10018010036,新竹市,東區,軍功里,814,128,844,405,-30,-277,-3.555,-68.395
10018010035,新竹市,東區,立功里,249,22,318,94,-69,-72,-21.698,-76.596
10018010037,新竹市,東區,建功里,1365,160,1437,522,-72,-362,-5.01,-69.349
10018010033,新竹市,東區,光明里,871,172,944,513,-73,-341,-7.733,-66.472
10018010042,新竹市,東區,龍山里,2370,498,2299,2028,71,-1530,3.088,-75.444
10018010047,新竹市,東區,科園里,1909,376,1895,1320,14,-944,0.739,-71.515
10018010041,新竹市,東區,埔頂里,1802,374,1320,1319,482,-945,36.515,-71.645
10018010043,新竹市,東區,新莊里,1333,258,1292,1012,41,-754,3.173,-74.506
10018010054,新竹市,東區,關新里,955,215,950,977,5,-762,0.526,-77.994
10018010046,新竹市,東區,關東里,1227,201,1161,798,66,-597,5.685,-74.812
10018010045,新竹市,東區,金山里,1333,207,1311,823,22,-616,1.678,-74.848
10018010044,新竹市,東區,仙水里,1396,292,1127,862,269,-570,23.869,-66.125
10018010032,新竹市,東區,仙宮里,348,72,323,256,25,-184,7.74,-71.875
10018010004,新竹市,東區,關帝里,100,49,87,125,13,-76,14.943,-60.8
10018010001,新竹市,東區,南門里,159,49,133,201,26,-152,19.549,-75.622
10018010003,新竹市,東區,南市里,144,87,136,228,8,-141,5.882,-61.842
10018010002,新竹市,東區,福德里,363,122,352,299,11,-177,3.125,-59.197
10018010016,新竹市,東區,振興里,1263,282,1170,1008,93,-726,7.949,-72.024
10018010029,新竹市,東區,新興里,721,207,650,689,71,-482,10.923,-69.956
10018010010,新竹市,東區,寺前里,180,52,146,167,34,-115,23.288,-68.862
10018010009,新竹市,東區,竹蓮里,129,63,252,283,-123,-220,-48.81,-77.739
10018010008,新竹市,東區,下竹里,112,31,252,283,-140,-252,-55.556,-89.046
10018010014,新竹市,東區,頂竹里,621,191,578,673,43,-482,7.439,-71.62
10018010015,新竹市,東區,南大里,307,89,284,347,23,-258,8.099,-74.352
10018010049,新竹市,東區,新光里,843,218,720,728,123,-510,17.083,-70.055
10018010028,新竹市,東區,光鎮里,793,187,774,738,19,-551,2.455,-74.661
10018010031,新竹市,東區,高峰里,1399,320,1293,1153,106,-833,8.198,-72.246
10018010052,新竹市,東區,湖濱里,931,232,867,762,64,-530,7.382,-69.554
10018010030,新竹市,東區,柴橋里,1406,289,1252,1056,154,-767,12.3,-72.633
10018010053,新竹市,東區,明湖里,1226,238,1017,737,209,-499,20.551,-67.707
10018020001,新竹市,北區,西門里,112,50,127,125,-15,-75,-11.811,-60.0
10018020004,新竹市,北區,中央里,63,28,68,128,-5,-100,-7.353,-78.125
10018020003,新竹市,北區,潛園里,135,40,137,192,-2,-152,-1.46,-79.167
10018020005,新竹市,北區,崇禮里,201,80,188,280,13,-200,6.915,-71.429
10018020006,新竹市,北區,石坊里,120,50,150,190,-30,-140,-20.0,-73.684
10018020007,新竹市,北區,興南里,282,89,150,190,132,-101,88.0,-53.158
10018020002,新竹市,北區,仁德里,132,52,138,182,-6,-130,-4.348,-71.429
10018020031,新竹市,北區,育英里,705,206,691,802,14,-596,2.026,-74.314
10018020044,新竹市,北區,台溪里,346,106,306,297,40,-191,13.072,-64.31
10018020032,新竹市,北區,曲溪里,1244,270,1030,958,214,-688,20.777,-71.816
10018020033,新竹市,北區,西雅里,611,198,519,675,92,-477,17.726,-70.667
10018020030,新竹市,北區,客雅里,404,132,331,367,73,-235,22.054,-64.033
10018020045,新竹市,北區,中雅里,1064,174,1015,550,49,-376,4.828,-68.364
10018020034,新竹市,北區,南勢里,922,298,161,202,761,96,472.671,47.525
10018020035,新竹市,北區,大鵬里,56,4,161,202,-105,-198,-65.217,-98.02
10018020010,新竹市,北區,大同里,190,62,217,166,-27,-104,-12.442,-62.651
10018020011,新竹市,北區,中山里,198,64,145,236,53,-172,36.552,-72.881
10018020009,新竹市,北區,中興里,192,66,188,220,4,-154,2.128,-70.0
10018020013,新竹市,北區,新民里,337,84,319,361,18,-277,5.643,-76.731
10018020012,新竹市,北區,長和里,307,108,259,341,48,-233,18.533,-68.328
10018020008,新竹市,北區,北門里,212,78,196,245,16,-167,8.163,-68.163
10018020014,新竹市,北區,民富里,959,275,863,1038,96,-763,11.124,-73.507
10018020037,新竹市,北區,磐石里,1184,357,1094,1224,90,-867,8.227,-70.833
10018020038,新竹市,北區,新雅里,919,245,765,888,154,-643,20.131,-72.41
10018020016,新竹市,北區,文雅里,922,251,879,901,43,-650,4.892,-72.142
10018020015,新竹市,北區,水田里,780,221,690,650,90,-429,13.043,-66.0
10018020017,新竹市,北區,光田里,520,116,522,435,-2,-319,-0.383,-73.333
10018020039,新竹市,北區,光華里,822,169,805,690,17,-521,2.112,-75.507
10018020040,新竹市,北區,金華里,1208,288,1145,1043,63,-755,5.502,-72.387
10018020021,新竹市,北區,湳雅里,697,185,677,599,20,-414,2.954,-69.115
10018020043,新竹市,北區,金雅里,1075,245,643,678,432,-433,67.185,-63.864
10018020042,新竹市,北區,湳中里,1962,444,1663,1300,299,-856,17.98,-65.846
10018020022,新竹市,北區,舊社里,1496,385,1378,1240,118,-855,8.563,-68.952
10018020041,新竹市,北區,金竹里,1434,305,1335,1078,99,-773,7.416,-71.707
10018020023,新竹市,北區,武陵里,1580,140,1683,453,-103,-313,-6.12,-69.095
10018020019,新竹市,北區,福林里,985,210,990,727,-5,-517,-0.505,-71.114
10018020036,新竹市,北區,境福里,1096,281,1096,1012,0,-731,0.0,-72.233
10018020018,新竹市,北區,士林里,498,141,345,448,153,-307,44.348,-68.527
10018020020,新竹市,北區,古賢里,159,59,144,209,15,-150,10.417,-71.77
10018020024,新竹市,北區,南寮里,1109,183,997,1016,112,-833,11.234,-81.988
10018020026,新竹市,北區,康樂里,756,202,566,628,190,-426,33.569,-67.834
10018020028,新竹市,北區,中寮里,900,213,698,664,202,-451,28.94,-67.922
10018020029,新竹市,北區,海濱里,982,173,707,726,275,-553,38.897,-76.171
10018020027,新竹市,北區,港北里,437,147,329,412,108,-265,32.827,-64.32
10018020025,新竹市,北區,舊港里,122,40,108,113,14,-73,12.963,-64.602
10018030009,新竹市,香山區,頂埔里,1082,304,984,979,98,-675,9.959,-68.948
10018030024,新竹市,香山區,頂福里,1109,225,914,852,195,-627,21.335,-73.592
10018030007,新竹市,香山區,中埔里,672,164,625,655,47,-491,7.52,-74.962
10018030008,新竹市,香山區,牛埔里,1106,235,882,838,224,-603,25.397,-71.957
10018030006,新竹市,香山區,埔前里,663,175,561,740,102,-565,18.182,-76.351
10018030005,新竹市,香山區,樹下里,361,146,310,590,51,-444,16.452,-75.254
10018030004,新竹市,香山區,浸水里,457,159,326,498,131,-339,40.184,-68.072
10018030003,新竹市,香山區,虎林里,503,110,434,463,69,-353,15.899,-76.242
10018030002,新竹市,香山區,虎山里,1044,316,892,1180,152,-864,17.04,-73.22
10018030001,新竹市,香山區,港南里,551,190,374,671,177,-481,47.326,-71.684
10018030010,新竹市,香山區,東香里,1188,219,1030,781,158,-562,15.34,-71.959
10018030011,新竹市,香山區,香村里,915,180,776,637,139,-457,17.912,-71.743
10018030012,新竹市,香山區,香山里,984,246,761,821,223,-575,29.304,-70.037
10018030013,新竹市,香山區,大庄里,608,190,447,616,161,-426,36.018,-69.156
10018030014,新竹市,香山區,美山里,222,68,177,254,45,-186,25.424,-73.228
10018030015,新竹市,香山區,朝山里,480,114,361,412,119,-298,32.964,-72.33
10018030016,新竹市,香山區,海山里,563,138,446,429,117,-291,26.233,-67.832
10018030022,新竹市,香山區,鹽水里,312,86,257,294,55,-208,21.401,-70.748
10018030021,新竹市,香山區,內湖里,867,192,716,766,151,-574,21.089,-74.935
10018030023,新竹市,香山區,南港里,158,64,130,207,28,-143,21.538,-69.082
10018030020,新竹市,香山區,中隘里,470,95,350,276,120,-181,34.286,-65.58
10018030019,新竹市,香山區,南隘里,196,46,162,136,34,-90,20.988,-66.176
10018030018,新竹市,香山區,大湖里,215,48,161,168,54,-120,33.54,-71.429
10018030017,新竹市,香山區,茄苳里,203,51,137,136,66,-85,48.175,-62.5
10015010009,花蓮縣,花蓮市,民德里,375,70,419,238,-44,-168,-10.501,-70.588
10015010018,花蓮縣,花蓮市,民勤里,746,114,855,395,-109,-281,-12.749,-71.139
10015010010,花蓮縣,花蓮市,民意里,581,66,658,147,-77,-81,-11.702,-55.102
10015010025,花蓮縣,花蓮市,民心里,235,37,261,119,-26,-82,-9.962,-68.908
10015010033,花蓮縣,花蓮市,民享里,858,112,896,325,-38,-213,-4.241,-65.538
10015010045,花蓮縣,花蓮市,民孝里,900,117,1017,389,-117,-272,-11.504,-69.923
10015010002,花蓮縣,花蓮市,民運里,461,76,540,280,-79,-204,-14.63,-72.857
10015010017,花蓮縣,花蓮市,民政里,983,150,1060,477,-77,-327,-7.264,-68.553
10015010001,花蓮縣,花蓮市,民立里,347,67,405,216,-58,-149,-14.321,-68.981
10015010026,花蓮縣,花蓮市,民樂里,160,36,160,78,0,-42,0.0,-53.846
10015010034,花蓮縣,花蓮市,民有里,100,27,119,103,-19,-76,-15.966,-73.786
10015010027,花蓮縣,花蓮市,民主里,134,20,153,55,-19,-35,-12.418,-63.636
10015010003,花蓮縣,花蓮市,民族里,84,13,107,60,-23,-47,-21.495,-78.333
10015010019,花蓮縣,花蓮市,民生里,167,43,235,189,-68,-146,-28.936,-77.249
10015010035,花蓮縣,花蓮市,民權里,95,6,117,56,-22,-50,-18.803,-89.286
10015010020,花蓮縣,花蓮市,主商里,91,16,110,105,-19,-89,-17.273,-84.762
10015010028,花蓮縣,花蓮市,主勤里,147,52,198,135,-51,-83,-25.758,-61.481
10015010013,花蓮縣,花蓮市,主工里,110,18,131,96,-21,-78,-16.031,-81.25
10015010004,花蓮縣,花蓮市,主信里,141,34,158,115,-17,-81,-10.759,-70.435
10015010012,花蓮縣,花蓮市,主義里,109,22,130,68,-21,-46,-16.154,-67.647
10015010005,花蓮縣,花蓮市,主睦里,112,16,122,84,-10,-68,-8.197,-80.952
10015010036,花蓮縣,花蓮市,主計里,182,32,202,103,-20,-71,-9.901,-68.932
10015010006,花蓮縣,花蓮市,主和里,640,125,685,409,-45,-284,-6.569,-69.438
10015010021,花蓮縣,花蓮市,主學里,372,77,444,271,-72,-194,-16.216,-71.587
10015010014,花蓮縣,花蓮市,主農里,879,131,862,467,17,-336,1.972,-71.949
10015010042,花蓮縣,花蓮市,主安里,549,109,572,284,-23,-175,-4.021,-61.62
10015010037,花蓮縣,花蓮市,主權里,1228,209,1308,667,-80,-458,-6.116,-68.666
10015010029,花蓮縣,花蓮市,主力里,548,86,640,407,-92,-321,-14.375,-78.87
10015010008,花蓮縣,花蓮市,國風里,660,129,801,448,-141,-319,-17.603,-71.205
10015010007,花蓮縣,花蓮市,國威里,251,60,330,246,-79,-186,-23.939,-75.61
10015010015,花蓮縣,花蓮市,國治里,158,30,178,122,-20,-92,-11.236,-75.41
10015010030,花蓮縣,花蓮市,國安里,98,24,124,74,-26,-50,-20.968,-67.568
10015010022,花蓮縣,花蓮市,國光里,247,42,318,148,-71,-106,-22.327,-71.622
10015010039,花蓮縣,花蓮市,國防里,177,35,188,128,-11,-93,-5.851,-72.656
10015010038,花蓮縣,花蓮市,國華里,461,72,550,320,-89,-248,-16.182,-77.5
10015010031,花蓮縣,花蓮市,國魂里,425,70,475,301,-50,-231,-10.526,-76.744
10015010023,花蓮縣,花蓮市,國聯里,611,121,621,401,-10,-280,-1.61,-69.825
10015010043,花蓮縣,花蓮市,國盛里,815,121,824,413,-9,-292,-1.092,-70.702
10015010024,花蓮縣,花蓮市,國強里,505,77,417,226,88,-149,21.103,-65.929
10015010016,花蓮縣,花蓮市,國富里,1165,204,1277,683,-112,-479,-8.771,-70.132
10015010041,花蓮縣,花蓮市,國裕里,1044,167,1102,516,-58,-349,-5.263,-67.636
10015010032,花蓮縣,花蓮市,國慶里,230,42,224,181,6,-139,2.679,-76.796
10015010044,花蓮縣,花蓮市,國興里,1048,175,1139,545,-91,-370,-7.989,-67.89
10015010040,花蓮縣,花蓮市,國福里,283,56,332,133,-49,-77,-14.759,-57.895
10015040001,花蓮縣,新城鄉,新城村,279,61,309,189,-30,-128,-9.709,-67.725
10015040002,花蓮縣,新城鄉,順安村,149,43,134,176,15,-133,11.194,-75.568
10015040003,花蓮縣,新城鄉,康樂村,538,88,536,267,2,-179,0.373,-67.041
10015040008,花蓮縣,新城鄉,大漢村,636,90,679,200,-43,-110,-6.333,-55.0
10015040009,花蓮縣,新城鄉,新秀村,390,76,,,,,,
10015040004,花蓮縣,新城鄉,北埔村,729,123,1005,435,-276,-312,-27.463,-71.724
10015040005,花蓮縣,新城鄉,佳林村,227,32,246,124,-19,-92,-7.724,-74.194
10015040006,花蓮縣,新城鄉,嘉里村,874,121,904,343,-30,-222,-3.319,-64.723
10015040007,花蓮縣,新城鄉,嘉新村,265,19,303,90,-38,-71,-12.541,-78.889
10015110009,花蓮縣,秀林鄉,和平村,350,38,332,124,18,-86,5.422,-69.355
10015110001,花蓮縣,秀林鄉,崇德村,303,27,318,63,-15,-36,-4.717,-57.143
10015110002,花蓮縣,秀林鄉,富世村,335,78,407,173,-72,-95,-17.69,-54.913
10015110003,花蓮縣,秀林鄉,秀林村,410,55,386,138,24,-83,6.218,-60.145
10015110007,花蓮縣,秀林鄉,景美村,342,38,363,137,-21,-99,-5.785,-72.263
10015110008,花蓮縣,秀林鄉,佳民村,301,25,304,53,-3,-28,-0.987,-52.83
10015110004,花蓮縣,秀林鄉,水源村,298,30,328,59,-30,-29,-9.146,-49.153
10015110005,花蓮縣,秀林鄉,銅門村,305,23,331,66,-26,-43,-7.855,-65.152
10015110006,花蓮縣,秀林鄉,文蘭村,256,31,297,50,-41,-19,-13.805,-38.0
10015050003,花蓮縣,吉安鄉,太昌村,740,129,782,491,-42,-362,-5.371,-73.727
10015050004,花蓮縣,吉安鄉,永安村,1074,161,1099,543,-25,-382,-2.275,-70.35
10015050001,花蓮縣,吉安鄉,北昌村,1368,253,1867,1045,-499,-792,-26.727,-75.789
10015050019,花蓮縣,吉安鄉,吉昌村,324,49,,,,,,
10015050002,花蓮縣,吉安鄉,勝安村,1266,237,1272,745,-6,-508,-0.472,-68.188
10015050013,花蓮縣,吉安鄉,宜昌村,959,169,1014,501,-55,-332,-5.424,-66.267
10015050012,花蓮縣,吉安鄉,南昌村,1038,133,1032,441,6,-308,0.581,-69.841
10015050005,花蓮縣,吉安鄉,慶豐村,1743,305,1734,869,9,-564,0.519,-64.902
10015050006,花蓮縣,吉安鄉,吉安村,1353,207,1383,641,-30,-434,-2.169,-67.707
10015050007,花蓮縣,吉安鄉,福興村,766,134,739,432,27,-298,3.654,-68.981
10015050008,花蓮縣,吉安鄉,南華村,356,96,346,257,10,-161,2.89,-62.646
10015050009,花蓮縣,吉安鄉,干城村,292,33,320,95,-28,-62,-8.75,-65.263
10015050015,花蓮縣,吉安鄉,東昌村,1428,206,1458,549,-30,-343,-2.058,-62.477
10015050016,花蓮縣,吉安鄉,仁安村,458,70,482,249,-24,-179,-4.979,-71.888
10015050017,花蓮縣,吉安鄉,仁和村,1023,153,1020,492,3,-339,0.294,-68.902
10015050014,花蓮縣,吉安鄉,仁里村,1480,236,1563,729,-83,-493,-5.31,-67.627
10015050011,花蓮縣,吉安鄉,稻香村,855,116,831,384,24,-268,2.888,-69.792
10015050010,花蓮縣,吉安鄉,永興村,750,99,724,282,26,-183,3.591,-64.894
10015050018,花蓮縣,吉安鄉,光華村,492,48,575,175,-83,-127,-14.435,-72.571
10015060002,花蓮縣,壽豐鄉,溪口村,198,50,258,127,-60,-77,-23.256,-60.63
10015060001,花蓮縣,壽豐鄉,樹湖村,87,15,84,54,3,-39,3.571,-72.222
10015060003,花蓮縣,壽豐鄉,豐山村,394,58,441,211,-47,-153,-10.658,-72.512
10015060004,花蓮縣,壽豐鄉,豐裡村,298,52,300,172,-2,-120,-0.667,-69.767
10015060005,花蓮縣,壽豐鄉,豐坪村,200,38,207,89,-7,-51,-3.382,-57.303
10015060007,花蓮縣,壽豐鄉,壽豐村,341,58,374,201,-33,-143,-8.824,-71.144
10015060006,花蓮縣,壽豐鄉,共和村,197,44,219,99,-22,-55,-10.046,-55.556
10015060008,花蓮縣,壽豐鄉,光榮村,204,24,231,53,-27,-29,-11.688,-54.717
10015060009,花蓮縣,壽豐鄉,池南村,174,26,198,96,-24,-70,-12.121,-72.917
10015060010,花蓮縣,壽豐鄉,平和村,282,66,312,222,-30,-156,-9.615,-70.27
10015060011,花蓮縣,壽豐鄉,志學村,576,159,540,395,36,-236,6.667,-59.747
10015060012,花蓮縣,壽豐鄉,米棧村,64,8,80,30,-16,-22,-20.0,-73.333
10015060013,花蓮縣,壽豐鄉,月眉村,195,28,213,54,-18,-26,-8.451,-48.148
10015060015,花蓮縣,壽豐鄉,鹽寮村,99,16,115,52,-16,-36,-13.913,-69.231
10015060014,花蓮縣,壽豐鄉,水璉村,142,18,176,54,-34,-36,-19.318,-66.667
10015020001,花蓮縣,鳳林鎮,鳳仁里,345,30,298,135,47,-105,15.772,-77.778
10015020002,花蓮縣,鳳林鎮,鳳義里,146,27,205,56,-59,-29,-28.78,-51.786
10015020003,花蓮縣,鳳林鎮,鳳禮里,160,26,180,80,-20,-54,-11.111,-67.5
10015020004,花蓮縣,鳳林鎮,鳳智里,300,28,312,96,-12,-68,-3.846,-70.833
10015020005,花蓮縣,鳳林鎮,鳳信里,335,38,355,108,-20,-70,-5.634,-64.815
10015020006,花蓮縣,鳳林鎮,山興里,132,25,131,36,1,-11,0.763,-30.556
10015020007,花蓮縣,鳳林鎮,大榮里,282,54,293,165,-11,-111,-3.754,-67.273
10015020008,花蓮縣,鳳林鎮,北林里,114,29,110,94,4,-65,3.636,-69.149
10015020009,花蓮縣,鳳林鎮,南平里,121,23,137,71,-16,-48,-11.679,-67.606
10015020010,花蓮縣,鳳林鎮,林榮里,217,25,235,104,-18,-79,-7.66,-75.962
10015020011,花蓮縣,鳳林鎮,長橋里,194,39,212,107,-18,-68,-8.491,-63.551
10015020012,花蓮縣,鳳林鎮,森榮里,26,3,36,8,-10,-5,-27.778,-62.5
10015070002,花蓮縣,光復鄉,大華村,262,44,257,157,5,-113,1.946,-71.975
10015070001,花蓮縣,光復鄉,大安村,197,33,204,116,-7,-83,-3.431,-71.552
10015070003,花蓮縣,光復鄉,大平村,194,45,210,60,-16,-15,-7.619,-25.0
10015070004,花蓮縣,光復鄉,大馬村,193,28,211,43,-18,-15,-8.531,-34.884
10015070005,花蓮縣,光復鄉,大同村,235,33,246,107,-11,-74,-4.472,-69.159
10015070011,花蓮縣,光復鄉,東富村,171,23,248,45,-77,-22,-31.048,-48.889
10015070012,花蓮縣,光復鄉,西富村,184,28,233,75,-49,-47,-21.03,-62.667
10015070013,花蓮縣,光復鄉,南富村,191,21,174,78,17,-57,9.77,-73.077
10015070014,花蓮縣,光復鄉,北富村,198,14,211,44,-13,-30,-6.161,-68.182
10015070006,花蓮縣,光復鄉,大進村,113,16,127,51,-14,-35,-11.024,-68.627
10015070007,花蓮縣,光復鄉,大全村,126,34,142,84,-16,-50,-11.268,-59.524
10015070008,花蓮縣,光復鄉,大興村,94,17,128,32,-34,-15,-26.562,-46.875
10015070009,花蓮縣,光復鄉,大富村,63,8,64,41,-1,-33,-1.562,-80.488
10015070010,花蓮縣,光復鄉,大豐村,90,12,92,51,-2,-39,-2.174,-76.471
10015080005,花蓮縣,豐濱鄉,靜浦村,136,19,157,26,-21,-7,-13.376,-26.923
10015080004,花蓮縣,豐濱鄉,港口村,151,29,163,63,-12,-34,-7.362,-53.968
10015080001,花蓮縣,豐濱鄉,豐濱村,276,49,301,103,-25,-54,-8.306,-52.427
10015080002,花蓮縣,豐濱鄉,新社村,117,20,121,39,-4,-19,-3.306,-48.718
10015080003,花蓮縣,豐濱鄉,磯崎村,91,7,99,19,-8,-12,-8.081,-63.158
10015120001,花蓮縣,萬榮鄉,西林村,250,20,251,46,-1,-26,-0.398,-56.522
10015120002,花蓮縣,萬榮鄉,見晴村,97,8,103,18,-6,-10,-5.825,-55.556
10015120003,花蓮縣,萬榮鄉,萬榮村,153,15,160,36,-7,-21,-4.375,-58.333
10015120004,花蓮縣,萬榮鄉,明利村,149,22,152,29,-3,-7,-1.974,-24.138
10015120005,花蓮縣,萬榮鄉,馬遠村,243,38,206,55,37,-17,17.961,-30.909
10015120006,花蓮縣,萬榮鄉,紅葉村,200,22,218,42,-18,-20,-8.257,-47.619
10015090001,花蓮縣,瑞穗鄉,瑞穗村,413,57,436,194,-23,-137,-5.275,-70.619
10015090002,花蓮縣,瑞穗鄉,瑞美村,424,68,436,199,-12,-131,-2.752,-65.829
10015090003,花蓮縣,瑞穗鄉,瑞良村,118,15,126,68,-8,-53,-6.349,-77.941
10015090004,花蓮縣,瑞穗鄉,瑞祥村,181,29,191,104,-10,-75,-5.236,-72.115
10015090005,花蓮縣,瑞穗鄉,瑞北村,121,10,120,40,1,-30,0.833,-75.0
10015090006,花蓮縣,瑞穗鄉,舞鶴村,174,28,209,92,-35,-64,-16.746,-69.565
10015090007,花蓮縣,瑞穗鄉,鶴岡村,171,17,200,50,-29,-33,-14.5,-66.0
10015090008,花蓮縣,瑞穗鄉,奇美村,62,4,62,11,0,-7,0.0,-63.636
10015090009,花蓮縣,瑞穗鄉,富源村,112,16,135,68,-23,-52,-17.037,-76.471
10015090010,花蓮縣,瑞穗鄉,富民村,145,15,183,37,-38,-22,-20.765,-59.459
10015090011,花蓮縣,瑞穗鄉,富興村,121,24,117,81,4,-57,3.419,-70.37
10015030001,花蓮縣,玉里鎮,中城里,1212,181,1166,577,46,-396,3.945,-68.631
10015030005,花蓮縣,玉里鎮,國武里,260,54,287,159,-27,-105,-9.408,-66.038
10015030002,花蓮縣,玉里鎮,啟模里,295,54,330,144,-35,-90,-10.606,-62.5
10015030004,花蓮縣,玉里鎮,泰昌里,226,18,248,88,-22,-70,-8.871,-79.545
10015030003,花蓮縣,玉里鎮,永昌里,207,29,239,96,-32,-67,-13.389,-69.792
10015030015,花蓮縣,玉里鎮,大禹里,229,27,214,70,15,-43,7.009,-61.429
10015030014,花蓮縣,玉里鎮,三民里,120,21,155,86,-35,-65,-22.581,-75.581
10015030006,花蓮縣,玉里鎮,源城里,238,47,220,94,18,-47,8.182,-50.0
10015030007,花蓮縣,玉里鎮,長良里,110,22,113,35,-3,-13,-2.655,-37.143
10015030008,花蓮縣,玉里鎮,樂合里,189,25,229,51,-40,-26,-17.467,-50.98
10015030009,花蓮縣,玉里鎮,東豐里,86,14,116,37,-30,-23,-25.862,-62.162
10015030010,花蓮縣,玉里鎮,觀音里,263,45,304,95,-41,-50,-13.487,-52.632
10015030011,花蓮縣,玉里鎮,松浦里,173,31,232,74,-59,-43,-25.431,-58.108
10015030012,花蓮縣,玉里鎮,春日里,146,35,182,69,-36,-34,-19.78,-49.275
10015030013,花蓮縣,玉里鎮,德武里,157,11,159,42,-2,-31,-1.258,-73.81
10015100001,花蓮縣,富里鄉,吳江村,87,5,94,31,-7,-26,-7.447,-83.871
10015100002,花蓮縣,富里鄉,東里村,144,30,148,84,-4,-54,-2.703,-64.286
10015100003,花蓮縣,富里鄉,萬寧村,109,22,142,32,-33,-10,-23.239,-31.25
10015100004,花蓮縣,富里鄉,新興村,99,8,104,40,-5,-32,-4.808,-80.0
10015100005,花蓮縣,富里鄉,竹田村,252,16,234,83,18,-67,7.692,-80.723
10015100006,花蓮縣,富里鄉,羅山村,86,7,90,36,-4,-29,-4.444,-80.556
10015100007,花蓮縣,富里鄉,石牌村,184,23,167,64,17,-41,10.18,-64.062
10015100008,花蓮縣,富里鄉,明里村,74,12,92,40,-18,-28,-19.565,-70.0
10015100009,花蓮縣,富里鄉,富里村,244,44,243,156,1,-112,0.412,-71.795
10015100010,花蓮縣,富里鄉,永豐村,103,7,100,48,3,-41,3.0,-85.417
10015100011,花蓮縣,富里鄉,豐南村,129,9,129,29,0,-20,0.0,-68.966
10015100012,花蓮縣,富里鄉,富南村,71,17,80,55,-9,-38,-11.25,-69.091
10015100013,花蓮縣,富里鄉,學田村,109,23,108,85,1,-62,0.926,-72.941
10015130001,花蓮縣,卓溪鄉,崙山村,111,7,124,15,-13,-8,-10.484,-53.333
10015130002,花蓮縣,卓溪鄉,立山村,198,17,207,28,-9,-11,-4.348,-39.286
10015130003,花蓮縣,卓溪鄉,太平村,178,10,212,26,-34,-16,-16.038,-61.538
10015130004,花蓮縣,卓溪鄉,卓溪村,190,11,170,21,20,-10,11.765,-47.619
10015130005,花蓮縣,卓溪鄉,卓清村,210,21,207,23,3,-2,1.449,-8.696
10015130006,花蓮縣,卓溪鄉,古風村,248,20,252,35,-4,-15,-1.587,-42.857
10017010021,基隆市,中正區,長潭里,59,52,61,141,-2,-89,-3.279,-63.121
10017010022,基隆市,中正區,砂子里,1149,284,873,959,276,-675,31.615,-70.386
10017010019,基隆市,中正區,八斗里,136,124,167,434,-31,-310,-18.563,-71.429
10017010020,基隆市,中正區,碧砂里,160,82,155,246,5,-164,3.226,-66.667
10017010026,基隆市,中正區,新富里,996,189,889,727,107,-538,12.036,-74.003
10017010025,基隆市,中正區,新豐里,1614,324,1277,875,337,-551,26.39,-62.971
10017010018,基隆市,中正區,平寮里,194,62,191,267,3,-205,1.571,-76.779
10017010016,基隆市,中正區,社寮里,289,111,297,380,-8,-269,-2.694,-70.789
10017010017,基隆市,中正區,和憲里,169,40,178,120,-9,-80,-5.056,-66.667
10017010015,基隆市,中正區,海濱里,217,60,236,155,-19,-95,-8.051,-61.29
10017010024,基隆市,中正區,正濱里,183,37,195,161,-12,-124,-6.154,-77.019
10017010023,基隆市,中正區,中正里,275,74,285,289,-10,-215,-3.509,-74.394
10017010014,基隆市,中正區,中濱里,249,50,280,230,-31,-180,-11.071,-78.261
10017010013,基隆市,中正區,建國里,457,76,492,287,-35,-211,-7.114,-73.519
10017010012,基隆市,中正區,砂灣里,455,102,485,326,-30,-224,-6.186,-68.712
10017010011,基隆市,中正區,真砂里,279,70,330,274,-51,-204,-15.455,-74.453
10017010010,基隆市,中正區,正砂里,581,120,585,408,-4,-288,-0.684,-70.588
10017010009,基隆市,中正區,中砂里,283,95,312,233,-29,-138,-9.295,-59.227
10017010008,基隆市,中正區,入船里,174,53,175,145,-1,-92,-0.571,-63.448
10017010007,基隆市,中正區,正船里,264,70,301,231,-37,-161,-12.292,-69.697
10017010006,基隆市,中正區,中船里,233,67,216,251,17,-184,7.87,-73.307
10017010005,基隆市,中正區,港通里,304,111,285,298,19,-187,6.667,-62.752
10017010004,基隆市,中正區,義重里,215,72,214,186,1,-114,0.467,-61.29
10017010002,基隆市,中正區,正義里,290,76,295,248,-5,-172,-1.695,-69.355
10017010003,基隆市,中正區,信義里,180,64,189,182,-9,-118,-4.762,-64.835
10017010001,基隆市,中正區,德義里,130,56,153,156,-23,-100,-15.033,-64.103
10017070001,基隆市,信義區,仁壽里,272,71,280,225,-8,-154,-2.857,-68.444
10017070002,基隆市,信義區,仁義里,333,75,368,228,-35,-153,-9.511,-67.105
10017070003,基隆市,信義區,義昭里,361,81,342,258,19,-177,5.556,-68.605
10017070004,基隆市,信義區,義幸里,582,155,628,456,-46,-301,-7.325,-66.009
10017070005,基隆市,信義區,義民里,137,51,146,150,-9,-99,-6.164,-66.0
10017070006,基隆市,信義區,義和里,273,81,333,234,-60,-153,-18.018,-65.385
10017070007,基隆市,信義區,智慧里,206,51,197,152,9,-101,4.569,-66.447
10017070008,基隆市,信義區,智誠里,277,71,260,283,17,-212,6.538,-74.912
10017070009,基隆市,信義區,禮儀里,381,98,422,293,-41,-195,-9.716,-66.553
10017070010,基隆市,信義區,禮東里,388,79,419,288,-31,-209,-7.399,-72.569
10017070011,基隆市,信義區,信綠里,449,104,529,373,-80,-269,-15.123,-72.118
10017070016,基隆市,信義區,東信里,1096,202,1158,700,-62,-498,-5.354,-71.143
10017070012,基隆市,信義區,東光里,450,110,420,364,30,-254,7.143,-69.78
10017070013,基隆市,信義區,東明里,871,164,921,543,-50,-379,-5.429,-69.797
10017070014,基隆市,信義區,東安里,592,137,637,492,-45,-355,-7.064,-72.154
10017070018,基隆市,信義區,孝賢里,922,225,918,620,4,-395,0.436,-63.71
10017070020,基隆市,信義區,孝忠里,1778,358,1673,1315,105,-957,6.276,-72.776
10017070019,基隆市,信義區,孝德里,674,108,521,439,153,-331,29.367,-75.399
10017070017,基隆市,信義區,孝深里,1164,245,903,712,261,-467,28.904,-65.59
10017070015,基隆市,信義區,孝岡里,281,54,255,228,26,-174,10.196,-76.316
10017040001,基隆市,仁愛區,林泉里,306,94,329,313,-23,-219,-6.991,-69.968
10017040002,基隆市,仁愛區,花崗里,191,64,222,204,-31,-140,-13.964,-68.627
10017040003,基隆市,仁愛區,虹橋里,290,83,341,297,-51,-214,-14.956,-72.054
10017040004,基隆市,仁愛區,水錦里,352,97,388,309,-36,-212,-9.278,-68.608
10017040005,基隆市,仁愛區,智仁里,422,111,499,415,-77,-304,-15.431,-73.253
10017040006,基隆市,仁愛區,和明里,331,83,374,309,-43,-226,-11.497,-73.139
10017040007,基隆市,仁愛區,忠勇里,148,56,156,201,-8,-145,-5.128,-72.139
10017040008,基隆市,仁愛區,玉田里,155,71,202,217,-47,-146,-23.267,-67.281
10017040009,基隆市,仁愛區,仁德里,142,50,176,207,-34,-157,-19.318,-75.845
10017040010,基隆市,仁愛區,博愛里,295,98,352,335,-57,-237,-16.193,-70.746
10017040011,基隆市,仁愛區,福仁里,177,62,137,193,40,-131,29.197,-67.876
10017040012,基隆市,仁愛區,誠仁里,175,59,176,211,-1,-152,-0.568,-72.038
10017040013,基隆市,仁愛區,吉仁里,471,160,478,512,-7,-352,-1.464,-68.75
10017040014,基隆市,仁愛區,育仁里,99,45,103,174,-4,-129,-3.883,-74.138
10017040015,基隆市,仁愛區,英仁里,214,87,218,257,-4,-170,-1.835,-66.148
10017040016,基隆市,仁愛區,龍門里,155,56,131,182,24,-126,18.321,-69.231
10017040017,基隆市,仁愛區,德厚里,405,125,374,347,31,-222,8.289,-63.977
10017040018,基隆市,仁愛區,曲水里,134,48,147,202,-13,-154,-8.844,-76.238
10017040019,基隆市,仁愛區,崇文里,199,66,187,199,12,-133,6.417,-66.834
10017040020,基隆市,仁愛區,文安里,151,40,131,150,20,-110,15.267,-73.333
10017040021,基隆市,仁愛區,兆連里,170,37,169,131,1,-94,0.592,-71.756
10017040022,基隆市,仁愛區,獅球里,184,41,188,151,-4,-110,-2.128,-72.848
10017040023,基隆市,仁愛區,書院里,262,62,180,193,82,-131,45.556,-67.876
10017040024,基隆市,仁愛區,朝棟里,682,124,711,431,-29,-307,-4.079,-71.23
10017040029,基隆市,仁愛區,光華里,512,178,512,520,0,-342,0.0,-65.769
10017040025,基隆市,仁愛區,明德里,123,38,155,159,-32,-121,-20.645,-76.101
10017040026,基隆市,仁愛區,同風里,91,26,114,133,-23,-107,-20.175,-80.451
10017040027,基隆市,仁愛區,文昌里,142,86,141,226,1,-140,0.709,-61.947
10017040028,基隆市,仁愛區,新店里,136,42,135,141,1,-99,0.741,-70.213
10017050001,基隆市,中山區,新建里,185,39,189,166,-4,-127,-2.116,-76.506
10017050002,基隆市,中山區,安民里,271,69,240,255,31,-186,12.917,-72.941
10017050003,基隆市,中山區,安平里,149,48,151,162,-2,-114,-1.325,-70.37
10017050004,基隆市,中山區,中山里,157,61,150,223,7,-162,4.667,-72.646
10017050005,基隆市,中山區,民治里,205,56,194,152,11,-96,5.67,-63.158
10017050006,基隆市,中山區,中興里,272,87,276,230,-4,-143,-1.449,-62.174
10017050007,基隆市,中山區,仁正里,158,37,182,124,-24,-87,-13.187,-70.161
10017050008,基隆市,中山區,健民里,250,83,248,246,2,-163,0.806,-66.26
10017050009,基隆市,中山區,通化里,215,44,214,160,1,-116,0.467,-72.5
10017050010,基隆市,中山區,居仁里,277,57,279,201,-2,-144,-0.717,-71.642
10017050011,基隆市,中山區,通明里,302,94,336,350,-34,-256,-10.119,-73.143
10017050023,基隆市,中山區,和平里,121,28,125,81,-4,-53,-3.2,-65.432
10017050014,基隆市,中山區,仙洞里,123,27,121,108,2,-81,1.653,-75.0
10017050015,基隆市,中山區,太白里,152,27,151,165,1,-138,0.662,-83.636
10017050012,基隆市,中山區,協和里,254,79,296,285,-42,-206,-14.189,-72.281
10017050013,基隆市,中山區,文化里,195,58,184,175,11,-117,5.978,-66.857
10017050022,基隆市,中山區,德安里,756,215,819,740,-63,-525,-7.692,-70.946
10017050020,基隆市,中山區,德和里,1796,359,1423,1037,373,-678,26.212,-65.381
10017050021,基隆市,中山區,中和里,1190,229,1236,908,-46,-679,-3.722,-74.78
10017050024,基隆市,中山區,和慶里,1130,277,1151,1038,-21,-761,-1.825,-73.314
10017050019,基隆市,中山區,西康里,317,85,274,297,43,-212,15.693,-71.38
10017050018,基隆市,中山區,西定里,174,57,161,178,13,-121,8.075,-67.978
10017050017,基隆市,中山區,西華里,172,76,192,213,-20,-137,-10.417,-64.319
10017050016,基隆市,中山區,西榮里,104,48,116,157,-12,-109,-10.345,-69.427
10017060003,基隆市,安樂區,新西里,233,56,251,235,-18,-179,-7.171,-76.17
10017060001,基隆市,安樂區,西川里,247,65,241,206,6,-141,2.49,-68.447
10017060002,基隆市,安樂區,定國里,192,76,195,207,-3,-131,-1.538,-63.285
10017060004,基隆市,安樂區,定邦里,229,71,250,226,-21,-155,-8.4,-68.584
10017060005,基隆市,安樂區,慈仁里,109,65,129,207,-20,-142,-15.504,-68.599
10017060006,基隆市,安樂區,干城里,365,99,360,344,5,-245,1.389,-71.221
10017060007,基隆市,安樂區,永康里,351,110,333,364,18,-254,5.405,-69.78
10017060009,基隆市,安樂區,安和里,136,76,156,217,-20,-141,-12.821,-64.977
10017060010,基隆市,安樂區,樂一里,135,48,99,121,36,-73,36.364,-60.331
10017060008,基隆市,安樂區,嘉仁里,607,221,627,728,-20,-507,-3.19,-69.643
10017060015,基隆市,安樂區,三民里,513,171,544,513,-31,-342,-5.699,-66.667
10017060025,基隆市,安樂區,壯觀里,1149,230,1055,717,94,-487,8.91,-67.922
10017060016,基隆市,安樂區,四維里,1334,305,1252,971,82,-666,6.55,-68.589
10017060017,基隆市,安樂區,五福里,810,187,810,676,0,-489,0.0,-72.337
10017060018,基隆市,安樂區,六合里,1034,239,1046,768,-12,-529,-1.147,-68.88
10017060019,基隆市,安樂區,七賢里,481,138,517,514,-36,-376,-6.963,-73.152
10017060022,基隆市,安樂區,長樂里,929,199,967,674,-38,-475,-3.93,-70.475
10017060020,基隆市,安樂區,鶯歌里,564,113,606,422,-42,-309,-6.931,-73.223
10017060024,基隆市,安樂區,鶯安里,1520,285,1350,905,170,-620,12.593,-68.508
10017060023,基隆市,安樂區,興寮里,1015,219,969,738,46,-519,4.747,-70.325
10017060011,基隆市,安樂區,外寮里,793,219,778,654,15,-435,1.928,-66.514
10017060014,基隆市,安樂區,新崙里,836,214,811,691,25,-477,3.083,-69.03
10017060021,基隆市,安樂區,武崙里,1223,296,1173,899,50,-603,4.263,-67.075
10017060012,基隆市,安樂區,中崙里,380,98,383,310,-3,-212,-0.783,-68.387
10017060013,基隆市,安樂區,內寮里,1088,276,1097,954,-9,-678,-0.82,-71.069
10017030001,基隆市,暖暖區,八西里,278,83,292,264,-14,-181,-4.795,-68.561
10017030011,基隆市,暖暖區,八中里,84,25,86,89,-2,-64,-2.326,-71.91
10017030002,基隆市,暖暖區,八堵里,114,36,130,147,-16,-111,-12.308,-75.51
10017030003,基隆市,暖暖區,八南里,154,39,123,145,31,-106,25.203,-73.103
10017030004,基隆市,暖暖區,過港里,784,201,846,649,-62,-448,-7.329,-69.029
10017030008,基隆市,暖暖區,暖暖里,616,148,570,517,46,-369,8.07,-71.373
10017030007,基隆市,暖暖區,暖同里,583,137,569,431,14,-294,2.46,-68.213
10017030009,基隆市,暖暖區,暖東里,61,10,62,80,-1,-70,-1.613,-87.5
10017030010,基隆市,暖暖區,暖西里,1045,281,1011,933,34,-652,3.363,-69.882
10017030005,基隆市,暖暖區,碇內里,603,108,581,469,22,-361,3.787,-76.972
10017030006,基隆市,暖暖區,碇和里,811,131,824,449,-13,-318,-1.578,-70.824
10017030013,基隆市,暖暖區,碇祥里,1458,270,1263,931,195,-661,15.439,-70.999
10017030012,基隆市,暖暖區,碇安里,1092,256,1073,918,19,-662,1.771,-72.113
10017020001,基隆市,七堵區,長興里,794,212,743,654,51,-442,6.864,-67.584
10017020002,基隆市,七堵區,正光里,540,153,499,523,41,-370,8.216,-70.746
10017020017,基隆市,七堵區,正明里,365,102,429,364,-64,-262,-14.918,-71.978
10017020003,基隆市,七堵區,富民里,837,211,801,657,36,-446,4.494,-67.884
10017020004,基隆市,七堵區,永平里,442,111,448,387,-6,-276,-1.339,-71.318
10017020005,基隆市,七堵區,永安里,497,139,514,422,-17,-283,-3.307,-67.062
10017020006,基隆市,七堵區,八德里,291,78,300,290,-9,-212,-3.0,-73.103
10017020007,基隆市,七堵區,自強里,267,70,256,215,11,-145,4.297,-67.442
10017020009,基隆市,七堵區,泰安里,950,217,857,786,93,-569,10.852,-72.392
10017020008,基隆市,七堵區,六堵里,478,122,405,428,73,-306,18.025,-71.495
10017020011,基隆市,七堵區,堵南里,395,93,346,384,49,-291,14.162,-75.781
10017020020,基隆市,七堵區,長安里,520,142,432,408,88,-266,20.37,-65.196
10017020010,基隆市,七堵區,堵北里,706,217,636,746,70,-529,11.006,-70.912
10017020018,基隆市,七堵區,百福里,1119,327,1053,1086,66,-759,6.268,-69.89
10017020019,基隆市,七堵區,實踐里,713,182,678,714,35,-532,5.162,-74.51
10017020012,基隆市,七堵區,瑪南里,67,28,70,95,-3,-67,-4.286,-70.526
10017020013,基隆市,七堵區,瑪東里,50,17,55,49,-5,-32,-9.091,-65.306
10017020014,基隆市,七堵區,瑪西里,59,37,56,76,3,-39,5.357,-51.316
10017020015,基隆市,七堵區,友一里,505,121,522,391,-17,-270,-3.257,-69.054
10017020016,基隆市,七堵區,友二里,91,45,87,140,4,-95,4.598,-67.857
10005010001,苗栗縣,苗栗市,中苗里,332,40,332,146,0,-106,0.0,-72.603
10005010003,苗栗縣,苗栗市,青苗里,244,30,237,122,7,-92,2.954,-75.41
10005010007,苗栗縣,苗栗市,維祥里,859,97,870,354,-11,-257,-1.264,-72.599
10005010006,苗栗縣,苗栗市,維新里,1058,97,1064,434,-6,-337,-0.564,-77.65
10005010004,苗栗縣,苗栗市,玉清里,728,90,765,268,-37,-178,-4.837,-66.418
10005010005,苗栗縣,苗栗市,玉華里,1077,115,1110,418,-33,-303,-2.973,-72.488
10005010008,苗栗縣,苗栗市,綠苗里,213,31,222,98,-9,-67,-4.054,-68.367
10005010009,苗栗縣,苗栗市,高苗里,910,112,847,360,63,-248,7.438,-68.889
10005010012,苗栗縣,苗栗市,新苗里,224,48,214,139,10,-91,4.673,-65.468
10005010010,苗栗縣,苗栗市,玉苗里,192,40,222,142,-30,-102,-13.514,-71.831
10005010011,苗栗縣,苗栗市,大同里,165,20,152,79,13,-59,8.553,-74.684
10005010014,苗栗縣,苗栗市,恭敬里,379,46,325,176,54,-130,16.615,-73.864
10005010023,苗栗縣,苗栗市,水源里,671,95,642,296,29,-201,4.517,-67.905
10005010013,苗栗縣,苗栗市,勝利里,1142,158,1127,515,15,-357,1.331,-69.32
10005010017,苗栗縣,苗栗市,清華里,908,128,941,447,-33,-319,-3.507,-71.365
10005010015,苗栗縣,苗栗市,上苗里,394,66,431,237,-37,-171,-8.585,-72.152
10005010016,苗栗縣,苗栗市,北苗里,1444,189,1421,654,23,-465,1.619,-71.101
10005010018,苗栗縣,苗栗市,嘉盛里,916,104,948,431,-32,-327,-3.376,-75.87
10005010019,苗栗縣,苗栗市,福星里,1169,147,1052,518,117,-371,11.122,-71.622
10005010025,苗栗縣,苗栗市,福安里,995,117,863,395,132,-278,15.295,-70.38
10005010026,苗栗縣,苗栗市,嘉新里,879,99,882,359,-3,-260,-0.34,-72.423
10005010002,苗栗縣,苗栗市,建功里,1205,137,1210,485,-5,-348,-0.413,-71.753
10005010022,苗栗縣,苗栗市,福麗里,1560,151,1466,585,94,-434,6.412,-74.188
10005010021,苗栗縣,苗栗市,文山里,1292,140,1107,494,185,-354,16.712,-71.66
10005010028,苗栗縣,苗栗市,文聖里,1071,123,860,403,211,-280,24.535,-69.479
10005010020,苗栗縣,苗栗市,新川里,284,31,300,142,-16,-111,-5.333,-78.169
10005010027,苗栗縣,苗栗市,南勢里,460,63,450,195,10,-132,2.222,-67.692
10005010024,苗栗縣,苗栗市,新英里,414,56,376,190,38,-134,10.106,-70.526
10005020001,苗栗縣,苑裡鎮,苑東里,472,131,387,433,85,-302,21.964,-69.746
10005020002,苗栗縣,苑裡鎮,苑南里,269,85,255,349,14,-264,5.49,-75.645
10005020003,苗栗縣,苑裡鎮,苑北里,141,51,144,216,-3,-165,-2.083,-76.389
10005020004,苗栗縣,苑裡鎮,西平里,229,95,227,348,2,-253,0.881,-72.701
10005020005,苗栗縣,苑裡鎮,苑港里,141,54,125,295,16,-241,12.8,-81.695
10005020006,苗栗縣,苑裡鎮,西勢里,434,128,291,418,143,-290,49.141,-69.378
10005020007,苗栗縣,苑裡鎮,海岸里,157,53,143,199,14,-146,9.79,-73.367
10005020008,苗栗縣,苑裡鎮,房裡里,379,106,341,433,38,-327,11.144,-75.52
10005020009,苗栗縣,苑裡鎮,客庄里,831,239,680,838,151,-599,22.206,-71.48
10005020010,苗栗縣,苑裡鎮,中正里,367,89,308,402,59,-313,19.156,-77.861
10005020011,苗栗縣,苑裡鎮,苑坑里,136,33,101,184,35,-151,34.653,-82.065
10005020012,苗栗縣,苑裡鎮,水坡里,96,34,72,152,24,-118,33.333,-77.632
10005020013,苗栗縣,苑裡鎮,新復里,290,55,251,284,39,-229,15.538,-80.634
10005020014,苗栗縣,苑裡鎮,山脚里,228,72,214,269,14,-197,6.542,-73.234
10005020015,苗栗縣,苑裡鎮,舊社里,329,90,291,333,38,-243,13.058,-72.973
10005020016,苗栗縣,苑裡鎮,福田里,227,56,197,229,30,-173,15.228,-75.546
10005020017,苗栗縣,苑裡鎮,石鎮里,95,24,86,100,9,-76,10.465,-76.0
10005020018,苗栗縣,苑裡鎮,蕉埔里,136,56,146,131,-10,-75,-6.849,-57.252
10005020023,苗栗縣,苑裡鎮,南勢里,100,38,84,137,16,-99,19.048,-72.263
10005020020,苗栗縣,苑裡鎮,泰田里,249,96,200,368,49,-272,24.5,-73.913
10005020021,苗栗縣,苑裡鎮,上舘里,309,84,251,304,58,-220,23.108,-72.368
10005020022,苗栗縣,苑裡鎮,玉田里,324,76,239,317,85,-241,35.565,-76.025
10005020019,苗栗縣,苑裡鎮,社苓里,434,101,315,460,119,-359,37.778,-78.043
10005020024,苗栗縣,苑裡鎮,山柑里,272,43,219,219,53,-176,24.201,-80.365
10005020025,苗栗縣,苑裡鎮,田心里,328,90,301,360,27,-270,8.97,-75.0
10005030001,苗栗縣,通霄鎮,通東里,181,61,179,228,2,-167,1.117,-73.246
10005030002,苗栗縣,通霄鎮,通西里,392,146,361,430,31,-284,8.587,-66.047
10005030003,苗栗縣,通霄鎮,平元里,366,107,313,407,53,-300,16.933,-73.71
10005030024,苗栗縣,通霄鎮,平安里,372,95,300,379,72,-284,24.0,-74.934
10005030005,苗栗縣,通霄鎮,圳頭里,116,35,112,135,4,-100,3.571,-74.074
10005030004,苗栗縣,通霄鎮,梅南里,226,62,201,315,25,-253,12.438,-80.317
10005030006,苗栗縣,通霄鎮,通南里,522,120,397,475,125,-355,31.486,-74.737
10005030014,苗栗縣,通霄鎮,內湖里,366,59,246,283,120,-224,48.78,-79.152
10005030015,苗栗縣,通霄鎮,楓樹里,79,21,79,66,0,-45,0.0,-68.182
10005030016,苗栗縣,通霄鎮,烏眉里,186,15,186,103,0,-88,0.0,-85.437
10005030017,苗栗縣,通霄鎮,福龍里,67,13,80,42,-13,-29,-16.25,-69.048
10005030018,苗栗縣,通霄鎮,福源里,142,25,114,109,28,-84,24.561,-77.064
10005030007,苗栗縣,通霄鎮,城北里,112,32,107,118,5,-86,4.673,-72.881
10005030008,苗栗縣,通霄鎮,城南里,120,36,142,171,-22,-135,-15.493,-78.947
10005030009,苗栗縣,通霄鎮,南和里,94,29,114,176,-20,-147,-17.544,-83.523
10005030010,苗栗縣,通霄鎮,福興里,116,16,110,114,6,-98,5.455,-85.965
10005030011,苗栗縣,通霄鎮,坪頂里,237,45,210,184,27,-139,12.857,-75.543
10005030012,苗栗縣,通霄鎮,五南里,211,41,215,226,-4,-185,-1.86,-81.858
10005030013,苗栗縣,通霄鎮,五北里,198,66,184,273,14,-207,7.609,-75.824
10005030019,苗栗縣,通霄鎮,通灣里,318,78,301,327,17,-249,5.648,-76.147
10005030020,苗栗縣,通霄鎮,新埔里,138,50,110,225,28,-175,25.455,-77.778
10005030021,苗栗縣,通霄鎮,內島里,101,24,91,129,10,-105,10.989,-81.395
10005030022,苗栗縣,通霄鎮,白東里,259,43,221,206,38,-163,17.195,-79.126
10005030023,苗栗縣,通霄鎮,白西里,126,30,107,119,19,-89,17.757,-74.79
10005040001,苗栗縣,竹南鎮,竹南里,446,100,475,336,-29,-236,-6.105,-70.238
10005040002,苗栗縣,竹南鎮,照南里,801,168,763,677,38,-509,4.98,-75.185
10005040003,苗栗縣,竹南鎮,正南里,531,179,486,480,45,-301,9.259,-62.708
10005040004,苗栗縣,竹南鎮,新南里,1438,293,1078,924,360,-631,33.395,-68.29
10005040005,苗栗縣,竹南鎮,大厝里,1367,252,1248,858,119,-606,9.535,-70.629
10005040006,苗栗縣,竹南鎮,營盤里,783,164,669,655,114,-491,17.04,-74.962
10005040007,苗栗縣,竹南鎮,聖福里,854,144,778,587,76,-443,9.769,-75.468
10005040008,苗栗縣,竹南鎮,竹興里,712,131,568,481,144,-350,25.352,-72.765
10005040025,苗栗縣,竹南鎮,龍山里,586,122,459,449,127,-327,27.669,-72.829
10005040024,苗栗縣,竹南鎮,天文里,595,77,512,332,83,-255,16.211,-76.807
10005040009,苗栗縣,竹南鎮,龍鳳里,487,108,410,341,77,-233,18.78,-68.328
10005040010,苗栗縣,竹南鎮,山佳里,1228,152,995,666,233,-514,23.417,-77.177
10005040023,苗栗縣,竹南鎮,佳興里,736,142,624,568,112,-426,17.949,-75.0
10005040011,苗栗縣,竹南鎮,中港里,273,46,223,181,50,-135,22.422,-74.586
10005040012,苗栗縣,竹南鎮,中華里,714,150,644,511,70,-361,10.87,-70.646
10005040013,苗栗縣,竹南鎮,中英里,362,59,305,232,57,-173,18.689,-74.569
10005040014,苗栗縣,竹南鎮,中美里,420,77,405,316,15,-239,3.704,-75.633
10005040015,苗栗縣,竹南鎮,開元里,299,78,230,208,69,-130,30.0,-62.5
10005040016,苗栗縣,竹南鎮,海口里,1030,180,739,617,291,-437,39.378,-70.827
10005040017,苗栗縣,竹南鎮,港墘里,545,109,440,383,105,-274,23.864,-71.54
10005040018,苗栗縣,竹南鎮,公舘里,266,41,254,120,12,-79,4.724,-65.833
10005040019,苗栗縣,竹南鎮,大埔里,1316,262,845,709,471,-447,55.74,-63.047
10005040020,苗栗縣,竹南鎮,頂埔里,496,106,404,393,92,-287,22.772,-73.028
10005040021,苗栗縣,竹南鎮,崎頂里,888,203,763,636,125,-433,16.383,-68.082
10005040022,苗栗縣,竹南鎮,公義里,198,35,193,172,5,-137,2.591,-79.651
10005050001,苗栗縣,頭份市,流東里,529,56,480,229,49,-173,10.208,-75.546
10005050002,苗栗縣,頭份市,珊湖里,403,67,426,194,-23,-127,-5.399,-65.464
10005050003,苗栗縣,頭份市,斗煥里,780,93,784,297,-4,-204,-0.51,-68.687
10005050004,苗栗縣,頭份市,新華里,1057,112,1041,376,16,-264,1.537,-70.213
10005050005,苗栗縣,頭份市,興隆里,1333,206,1108,523,225,-317,20.307,-60.612
10005050006,苗栗縣,頭份市,上埔里,717,78,660,260,57,-182,8.636,-70.0
10005050007,苗栗縣,頭份市,土牛里,294,45,228,142,66,-97,28.947,-68.31
10005050008,苗栗縣,頭份市,頭份里,895,129,797,382,98,-253,12.296,-66.23
10005050009,苗栗縣,頭份市,忠孝里,976,132,906,383,70,-251,7.726,-65.535
10005050030,苗栗縣,頭份市,自強里,515,61,501,277,14,-216,2.794,-77.978
10005050011,苗栗縣,頭份市,信義里,192,24,226,111,-34,-87,-15.044,-78.378
10005050010,苗栗縣,頭份市,仁愛里,394,51,382,196,12,-145,3.141,-73.98
10005050020,苗栗縣,頭份市,上興里,553,68,406,240,147,-172,36.207,-71.667
10005050021,苗栗縣,頭份市,下興里,626,101,595,293,31,-192,5.21,-65.529
10005050012,苗栗縣,頭份市,和平里,293,43,291,196,2,-153,0.687,-78.061
10005050016,苗栗縣,頭份市,山下里,1283,102,1017,520,266,-418,26.155,-80.385
10005050015,苗栗縣,頭份市,後庄里,1471,221,1061,664,410,-443,38.643,-66.717
10005050031,苗栗縣,頭份市,合興里,651,77,604,311,47,-234,7.781,-75.241
10005050032,苗栗縣,頭份市,文化里,1022,141,817,525,205,-384,25.092,-73.143
10005050033,苗栗縣,頭份市,中興里,769,94,679,331,90,-237,13.255,-71.601
10005050017,苗栗縣,頭份市,蟠桃里,860,110,780,400,80,-290,10.256,-72.5
10005050028,苗栗縣,頭份市,建國里,910,103,932,449,-22,-346,-2.361,-77.06
10005050029,苗栗縣,頭份市,成功里,1003,93,920,396,83,-303,9.022,-76.515
10005050013,苗栗縣,頭份市,民族里,624,94,551,239,73,-145,13.249,-60.669
10005050026,苗栗縣,頭份市,民權里,533,90,521,341,12,-251,2.303,-73.607
10005050014,苗栗縣,頭份市,東庄里,1389,203,1029,512,360,-309,34.985,-60.352
10005050018,苗栗縣,頭份市,田寮里,1134,153,911,502,223,-349,24.479,-69.522
10005050027,苗栗縣,頭份市,民生里,681,84,544,280,137,-196,25.184,-70.0
10005050019,苗栗縣,頭份市,蘆竹里,326,59,293,210,33,-151,11.263,-71.905
10005050022,苗栗縣,頭份市,尖山里,391,42,362,160,29,-118,8.011,-73.75
10005050024,苗栗縣,頭份市,廣興里,264,16,263,102,1,-86,0.38,-84.314
10005050023,苗栗縣,頭份市,尖下里,687,62,639,278,48,-216,7.512,-77.698
10005050025,苗栗縣,頭份市,濫坑里,626,74,588,237,38,-163,6.463,-68.776
10005060001,苗栗縣,後龍鎮,南龍里,290,54,246,215,44,-161,17.886,-74.884
10005060002,苗栗縣,後龍鎮,中龍里,128,37,152,163,-24,-126,-15.789,-77.301
10005060003,苗栗縣,後龍鎮,北龍里,236,76,237,262,-1,-186,-0.422,-70.992
10005060004,苗栗縣,後龍鎮,大庄里,881,175,814,663,67,-488,8.231,-73.605
10005060011,苗栗縣,後龍鎮,東明里,214,52,207,238,7,-186,3.382,-78.151
10005060013,苗栗縣,後龍鎮,灣寶里,193,40,171,208,22,-168,12.865,-80.769
10005060014,苗栗縣,後龍鎮,海寶里,126,40,147,160,-21,-120,-14.286,-75.0
10005060006,苗栗縣,後龍鎮,豐富里,361,52,346,166,15,-114,4.335,-68.675
10005060007,苗栗縣,後龍鎮,校椅里,366,65,262,131,104,-66,39.695,-50.382
10005060008,苗栗縣,後龍鎮,埔頂里,521,96,440,404,81,-308,18.409,-76.238
10005060009,苗栗縣,後龍鎮,新民里,265,56,278,214,-13,-158,-4.676,-73.832
10005060010,苗栗縣,後龍鎮,復興里,156,40,120,121,36,-81,30.0,-66.942
10005060012,苗栗縣,後龍鎮,大山里,235,65,236,258,-1,-193,-0.424,-74.806
10005060005,苗栗縣,後龍鎮,溪洲里,431,66,393,298,38,-232,9.669,-77.852
10005060015,苗栗縣,後龍鎮,外埔里,178,29,176,126,2,-97,1.136,-76.984
10005060016,苗栗縣,後龍鎮,海埔里,104,30,122,146,-18,-116,-14.754,-79.452
10005060017,苗栗縣,後龍鎮,秀水里,133,43,111,129,22,-86,19.82,-66.667
10005060018,苗栗縣,後龍鎮,水尾里,172,27,166,172,6,-145,3.614,-84.302
10005060019,苗栗縣,後龍鎮,龍津里,101,14,109,100,-8,-86,-7.339,-86.0
10005060020,苗栗縣,後龍鎮,龍坑里,215,52,169,240,46,-188,27.219,-78.333
10005060021,苗栗縣,後龍鎮,福寧里,89,20,107,106,-18,-86,-16.822,-81.132
10005060022,苗栗縣,後龍鎮,中和里,183,26,170,134,13,-108,7.647,-80.597
10005060023,苗栗縣,後龍鎮,南港里,192,39,170,187,22,-148,12.941,-79.144
10005070007,苗栗縣,卓蘭鎮,老庄里,376,76,370,374,6,-298,1.622,-79.679
10005070008,苗栗縣,卓蘭鎮,新榮里,213,51,184,239,29,-188,15.761,-78.661
10005070001,苗栗縣,卓蘭鎮,中街里,153,57,168,148,-15,-91,-8.929,-61.486
10005070002,苗栗縣,卓蘭鎮,新厝里,282,74,322,277,-40,-203,-12.422,-73.285
10005070004,苗栗縣,卓蘭鎮,豐田里,180,56,165,186,15,-130,9.091,-69.892
10005070005,苗栗縣,卓蘭鎮,西坪里,138,21,160,91,-22,-70,-13.75,-76.923
10005070010,苗栗縣,卓蘭鎮,苗豐里,153,29,128,137,25,-108,19.531,-78.832
10005070003,苗栗縣,卓蘭鎮,上新里,357,86,353,402,4,-316,1.133,-78.607
10005070009,苗栗縣,卓蘭鎮,內灣里,333,78,357,384,-24,-306,-6.723,-79.688
10005070011,苗栗縣,卓蘭鎮,坪林里,327,37,160,91,167,-54,104.375,-59.341
10005070006,苗栗縣,卓蘭鎮,景山里,151,32,148,125,3,-93,2.027,-74.4
10005080001,苗栗縣,大湖鄉,大湖村,437,45,450,183,-13,-138,-2.889,-75.41
10005080002,苗栗縣,大湖鄉,明湖村,166,18,201,55,-35,-37,-17.413,-67.273
10005080006,苗栗縣,大湖鄉,大寮村,294,30,285,138,9,-108,3.158,-78.261
10005080003,苗栗縣,大湖鄉,靜湖村,427,35,434,159,-7,-124,-1.613,-77.987
10005080004,苗栗縣,大湖鄉,富興村,253,51,238,152,15,-101,6.303,-66.447
10005080005,苗栗縣,大湖鄉,大南村,99,12,129,43,-30,-31,-23.256,-72.093
10005080007,苗栗縣,大湖鄉,南湖村,133,31,146,75,-13,-44,-8.904,-58.667
10005080009,苗栗縣,大湖鄉,東興村,126,33,158,76,-32,-43,-20.253,-56.579
10005080010,苗栗縣,大湖鄉,武榮村,116,15,131,51,-15,-36,-11.45,-70.588
10005080008,苗栗縣,大湖鄉,義和村,269,41,270,158,-1,-117,-0.37,-74.051
10005080011,苗栗縣,大湖鄉,栗林村,176,17,183,95,-7,-78,-3.825,-82.105
10005080012,苗栗縣,大湖鄉,新開村,145,12,174,124,-29,-112,-16.667,-90.323
10005090001,苗栗縣,公館鄉,館中村,398,78,393,252,5,-174,1.272,-69.048
10005090002,苗栗縣,公館鄉,館東村,649,71,648,282,1,-211,0.154,-74.823
10005090003,苗栗縣,公館鄉,館南村,957,132,848,409,109,-277,12.854,-67.726
10005090005,苗栗縣,公館鄉,中義村,584,74,500,263,84,-189,16.8,-71.863
10005090006,苗栗縣,公館鄉,玉泉村,676,80,606,317,70,-237,11.551,-74.763
10005090004,苗栗縣,公館鄉,大坑村,229,38,212,137,17,-99,8.019,-72.263
10005090008,苗栗縣,公館鄉,福基村,269,45,284,106,-15,-61,-5.282,-57.547
10005090011,苗栗縣,公館鄉,福德村,74,17,91,69,-17,-52,-18.681,-75.362
10005090009,苗栗縣,公館鄉,福星村,561,41,527,257,34,-216,6.452,-84.047
10005090007,苗栗縣,公館鄉,石墻村,353,32,372,149,-19,-117,-5.108,-78.523
10005090010,苗栗縣,公館鄉,開礦村,67,12,82,23,-15,-11,-18.293,-47.826
10005090012,苗栗縣,公館鄉,五谷村,582,103,533,324,49,-221,9.193,-68.21
10005090013,苗栗縣,公館鄉,玉谷村,386,33,357,175,29,-142,8.123,-81.143
10005090014,苗栗縣,公館鄉,鶴岡村,475,69,445,198,30,-129,6.742,-65.152
10005090015,苗栗縣,公館鄉,鶴山村,378,29,358,179,20,-150,5.587,-83.799
10005090017,苗栗縣,公館鄉,尖山村,394,48,333,203,61,-155,18.318,-76.355
10005090016,苗栗縣,公館鄉,仁安村,314,40,325,155,-11,-115,-3.385,-74.194
10005090018,苗栗縣,公館鄉,南河村,65,5,71,16,-6,-11,-8.451,-68.75
10005090019,苗栗縣,公館鄉,北河村,82,6,66,38,16,-32,24.242,-84.211
10005100002,苗栗縣,銅鑼鄉,銅鑼村,1253,131,1211,512,42,-381,3.468,-74.414
10005100004,苗栗縣,銅鑼鄉,樟樹村,323,37,273,131,50,-94,18.315,-71.756
10005100005,苗栗縣,銅鑼鄉,九湖村,281,32,295,123,-14,-91,-4.746,-73.984
10005100001,苗栗縣,銅鑼鄉,福興村,329,32,347,63,-18,-31,-5.187,-49.206
10005100003,苗栗縣,銅鑼鄉,朝陽村,503,37,489,192,14,-155,2.863,-80.729
10005100006,苗栗縣,銅鑼鄉,竹森村,253,25,244,87,9,-62,3.689,-71.264
10005100007,苗栗縣,銅鑼鄉,中平村,783,87,735,374,48,-287,6.531,-76.738
10005100008,苗栗縣,銅鑼鄉,興隆村,134,12,123,65,11,-53,8.943,-81.538
10005100009,苗栗縣,銅鑼鄉,盛隆村,84,15,92,51,-8,-36,-8.696,-70.588
10005100010,苗栗縣,銅鑼鄉,新隆村,134,13,156,71,-22,-58,-14.103,-81.69
10005110001,苗栗縣,南庄鄉,東村,275,42,312,105,-37,-63,-11.859,-60.0
10005110002,苗栗縣,南庄鄉,西村,136,14,156,67,-20,-53,-12.821,-79.104
10005110003,苗栗縣,南庄鄉,南江村,272,25,279,90,-7,-65,-2.509,-72.222
10005110004,苗栗縣,南庄鄉,田美村,165,14,189,85,-24,-71,-12.698,-83.529
10005110005,苗栗縣,南庄鄉,獅山村,145,26,184,80,-39,-54,-21.196,-67.5
10005110006,苗栗縣,南庄鄉,南富村,285,24,328,136,-43,-112,-13.11,-82.353
10005110007,苗栗縣,南庄鄉,員林村,286,22,259,124,27,-102,10.425,-82.258
10005110008,苗栗縣,南庄鄉,蓬萊村,169,18,185,46,-16,-28,-8.649,-60.87
10005110009,苗栗縣,南庄鄉,東河村,172,11,184,41,-12,-30,-6.522,-73.171
10005120001,苗栗縣,頭屋鄉,頭屋村,720,80,700,283,20,-203,2.857,-71.731
10005120004,苗栗縣,頭屋鄉,獅潭村,444,48,455,196,-11,-148,-2.418,-75.51
10005120003,苗栗縣,頭屋鄉,北坑村,179,23,184,60,-5,-37,-2.717,-61.667
10005120005,苗栗縣,頭屋鄉,曲洞村,271,33,268,130,3,-97,1.119,-74.615
10005120006,苗栗縣,頭屋鄉,飛鳳村,96,17,114,50,-18,-33,-15.789,-66.0
10005120002,苗栗縣,頭屋鄉,象山村,495,60,454,232,41,-172,9.031,-74.138
10005120007,苗栗縣,頭屋鄉,明德村,290,30,291,133,-1,-103,-0.344,-77.444
10005120008,苗栗縣,頭屋鄉,鳴鳳村,63,11,78,48,-15,-37,-19.231,-77.083
10005130001,苗栗縣,三義鄉,廣盛村,1109,131,1082,506,27,-375,2.495,-74.111
10005130004,苗栗縣,三義鄉,勝興村,928,115,836,489,92,-374,11.005,-76.483
10005130003,苗栗縣,三義鄉,双潭村,382,35,336,151,46,-116,13.69,-76.821
10005130002,苗栗縣,三義鄉,双湖村,507,69,474,217,33,-148,6.962,-68.203
10005130005,苗栗縣,三義鄉,西湖村,455,31,419,147,36,-116,8.592,-78.912
10005130006,苗栗縣,三義鄉,龍騰村,123,8,123,47,0,-39,0.0,-82.979
10005130007,苗栗縣,三義鄉,鯉魚潭村,263,56,220,246,43,-190,19.545,-77.236
10005140001,苗栗縣,西湖鄉,高埔村,163,12,185,45,-22,-33,-11.892,-73.333
10005140002,苗栗縣,西湖鄉,下埔村,159,13,152,42,7,-29,4.605,-69.048
10005140003,苗栗縣,西湖鄉,五湖村,196,20,198,81,-2,-61,-1.01,-75.309
10005140004,苗栗縣,西湖鄉,四湖村,138,12,152,53,-14,-41,-9.211,-77.358
10005140007,苗栗縣,西湖鄉,三湖村,196,25,218,96,-22,-71,-10.092,-73.958
10005140006,苗栗縣,西湖鄉,龍洞村,104,10,91,59,13,-49,14.286,-83.051
10005140005,苗栗縣,西湖鄉,金獅村,123,16,130,51,-7,-35,-5.385,-68.627
10005140008,苗栗縣,西湖鄉,湖東村,251,33,242,98,9,-65,3.719,-66.327
10005140009,苗栗縣,西湖鄉,二湖村,131,20,145,69,-14,-49,-9.655,-71.014
10005150001,苗栗縣,造橋鄉,造橋村,531,58,524,230,7,-172,1.336,-74.783
10005150002,苗栗縣,造橋鄉,平興村,124,17,126,49,-2,-32,-1.587,-65.306
10005150003,苗栗縣,造橋鄉,豐湖村,268,26,251,125,17,-99,6.773,-79.2
10005150004,苗栗縣,造橋鄉,大西村,906,91,792,412,114,-321,14.394,-77.913
10005150005,苗栗縣,造橋鄉,錦水村,126,19,124,58,2,-39,1.613,-67.241
10005150006,苗栗縣,造橋鄉,大龍村,146,27,126,66,20,-39,15.873,-59.091
10005150007,苗栗縣,造橋鄉,朝陽村,294,56,246,189,48,-133,19.512,-70.37
10005150008,苗栗縣,造橋鄉,談文村,231,32,181,110,50,-78,27.624,-70.909
10005150009,苗栗縣,造橋鄉,龍昇村,171,40,148,153,23,-113,15.541,-73.856
10005160001,苗栗縣,三灣鄉,三灣村,576,59,522,250,54,-191,10.345,-76.4
10005160002,苗栗縣,三灣鄉,內灣村,214,33,183,84,31,-51,16.94,-60.714
10005160003,苗栗縣,三灣鄉,銅鏡村,234,15,237,83,-3,-68,-1.266,-81.928
10005160004,苗栗縣,三灣鄉,頂寮村,70,9,46,27,24,-18,52.174,-66.667
10005160005,苗栗縣,三灣鄉,北埔村,109,18,100,60,9,-42,9.0,-70.0
10005160006,苗栗縣,三灣鄉,大河村,149,17,136,65,13,-48,9.559,-73.846
10005160007,苗栗縣,三灣鄉,大坪村,88,16,121,60,-33,-44,-27.273,-73.333
10005160008,苗栗縣,三灣鄉,永和村,95,13,121,40,-26,-27,-21.488,-67.5
10005170001,苗栗縣,獅潭鄉,百壽村,88,7,82,11,6,-4,7.317,-36.364
10005170002,苗栗縣,獅潭鄉,永興村,116,21,145,58,-29,-37,-20.0,-63.793
10005170003,苗栗縣,獅潭鄉,新店村,221,31,224,94,-3,-63,-1.339,-67.021
10005170004,苗栗縣,獅潭鄉,和興村,125,14,134,65,-9,-51,-6.716,-78.462
10005170005,苗栗縣,獅潭鄉,豐林村,126,15,150,50,-24,-35,-16.0,-70.0
10005170006,苗栗縣,獅潭鄉,新豐村,86,8,88,35,-2,-27,-2.273,-77.143
10005170007,苗栗縣,獅潭鄉,竹木村,202,15,203,75,-1,-60,-0.493,-80.0
10005180001,苗栗縣,泰安鄉,八卦村,40,10,64,20,-24,-10,-37.5,-50.0
10005180002,苗栗縣,泰安鄉,錦水村,232,24,256,57,-24,-33,-9.375,-57.895
10005180003,苗栗縣,泰安鄉,清安村,187,13,228,61,-41,-48,-17.982,-78.689
10005180004,苗栗縣,泰安鄉,大興村,132,8,161,29,-29,-21,-18.012,-72.414
10005180005,苗栗縣,泰安鄉,中興村,74,10,109,21,-35,-11,-32.11,-52.381
10005180006,苗栗縣,泰安鄉,梅園村,113,4,107,26,6,-22,5.607,-84.615
10005180007,苗栗縣,泰安鄉,象鼻村,131,13,147,32,-16,-19,-10.884,-59.375
10005180008,苗栗縣,泰安鄉,士林村,182,4,178,19,4,-15,2.247,-78.947
64000370008,高雄市,桃源區,梅山里,57,18,49,22,8,-4,16.327,-18.182
64000370007,高雄市,桃源區,拉芙蘭里,31,17,35,34,-4,-17,-11.429,-50.0
64000370006,高雄市,桃源區,復興里,67,9,54,7,13,2,24.074,28.571
64000370005,高雄市,桃源區,勤和里,40,6,26,19,14,-13,53.846,-68.421
64000370001,高雄市,桃源區,桃源里,115,8,116,27,-1,-19,-0.862,-70.37
64000370004,高雄市,桃源區,高中里,107,21,102,31,5,-10,4.902,-32.258
64000370003,高雄市,桃源區,建山里,106,11,71,28,35,-17,49.296,-60.714
64000370002,高雄市,桃源區,寶山里,84,11,79,23,5,-12,6.329,-52.174
64000380001,高雄市,那瑪夏區,達卡努瓦里,237,20,265,69,-28,-49,-10.566,-71.014
64000380002,高雄市,那瑪夏區,瑪雅里,179,8,172,30,7,-22,4.07,-73.333
64000380003,高雄市,那瑪夏區,南沙魯里,66,84,66,86,0,-2,0.0,-2.326
64000330001,高雄市,甲仙區,東安里,61,18,55,54,6,-36,10.909,-66.667
64000330002,高雄市,甲仙區,西安里,213,44,228,126,-15,-82,-6.579,-65.079
64000330003,高雄市,甲仙區,和安里,121,41,134,98,-13,-57,-9.701,-58.163
64000330004,高雄市,甲仙區,大田里,232,88,206,231,26,-143,12.621,-61.905
64000330005,高雄市,甲仙區,寶隆里,63,53,73,148,-10,-95,-13.699,-64.189
64000330006,高雄市,甲仙區,關山里,81,39,80,120,1,-81,1.25,-67.5
64000330007,高雄市,甲仙區,小林里,65,17,59,71,6,-54,10.169,-76.056
64000320001,高雄市,六龜區,新威里,95,47,75,152,20,-105,26.667,-69.079
64000320002,高雄市,六龜區,新興里,74,35,63,130,11,-95,17.46,-73.077
64000320003,高雄市,六龜區,新寮里,95,33,85,153,10,-120,11.765,-78.431
64000320004,高雄市,六龜區,新發里,86,48,82,142,4,-94,4.878,-66.197
64000320005,高雄市,六龜區,荖濃里,119,77,120,212,-1,-135,-0.833,-63.679
64000320006,高雄市,六龜區,六龜里,107,58,81,154,26,-96,32.099,-62.338
64000320007,高雄市,六龜區,義寶里,159,81,155,198,4,-117,2.581,-59.091
64000320008,高雄市,六龜區,興龍里,65,75,63,158,2,-83,3.175,-52.532
64000320009,高雄市,六龜區,中興里,234,67,244,216,-10,-149,-4.098,-68.981
64000320010,高雄市,六龜區,寶來里,95,26,89,151,6,-125,6.742,-82.781
64000320011,高雄市,六龜區,文武里,159,79,146,228,13,-149,8.904,-65.351
64000320012,高雄市,六龜區,大津里,58,25,41,81,17,-56,41.463,-69.136
64000340001,高雄市,杉林區,杉林里,54,39,53,113,1,-74,1.887,-65.487
64000340002,高雄市,杉林區,木梓里,52,25,49,107,3,-82,6.122,-76.636
64000340003,高雄市,杉林區,集來里,110,41,103,223,7,-182,6.796,-81.614
64000340004,高雄市,杉林區,新庄里,243,96,227,250,16,-154,7.048,-61.6
64000340005,高雄市,杉林區,上平里,287,90,220,248,67,-158,30.455,-63.71
64000340006,高雄市,杉林區,月眉里,319,77,275,274,44,-197,16.0,-71.898
64000340008,高雄市,杉林區,大愛里,216,75,205,314,11,-239,5.366,-76.115
64000340007,高雄市,杉林區,月美里,212,82,148,233,64,-151,43.243,-64.807
64000350001,高雄市,內門區,溝坪里,114,45,91,151,23,-106,25.275,-70.199
64000350002,高雄市,內門區,金竹里,69,61,63,140,6,-79,9.524,-56.429
64000350003,高雄市,內門區,永富里,139,60,115,170,24,-110,20.87,-64.706
64000350004,高雄市,內門區,永吉里,68,21,56,62,12,-41,21.429,-66.129
64000350005,高雄市,內門區,永興里,75,24,45,74,30,-50,66.667,-67.568
64000350006,高雄市,內門區,石坑里,67,17,43,75,24,-58,55.814,-77.333
64000350007,高雄市,內門區,內門里,158,56,151,212,7,-156,4.636,-73.585
64000350008,高雄市,內門區,內豊里,177,64,137,229,40,-165,29.197,-72.052
64000350009,高雄市,內門區,觀亭里,293,80,243,317,50,-237,20.576,-74.763
64000350010,高雄市,內門區,中埔里,86,24,97,78,-11,-54,-11.34,-69.231
64000350011,高雄市,內門區,內東里,108,51,98,181,10,-130,10.204,-71.823
64000350012,高雄市,內門區,內南里,48,25,46,54,2,-29,4.348,-53.704
64000350013,高雄市,內門區,東埔里,55,24,51,100,4,-76,7.843,-76.0
64000350014,高雄市,內門區,三平里,75,31,64,132,11,-101,17.188,-76.515
64000350015,高雄市,內門區,木柵里,75,35,48,137,27,-102,56.25,-74.453
64000350016,高雄市,內門區,內興里,47,45,23,141,24,-96,104.348,-68.085
64000350017,高雄市,內門區,瑞山里,59,19,58,59,1,-40,1.724,-67.797
64000350018,高雄市,內門區,光興里,92,32,80,113,12,-81,15.0,-71.681
64000300001,高雄市,旗山區,太平里,379,186,340,492,39,-306,11.471,-62.195
64000300002,高雄市,旗山區,大德里,454,207,409,508,45,-301,11.002,-59.252
64000300003,高雄市,旗山區,湄洲里,223,134,219,362,4,-228,1.826,-62.983
64000300004,高雄市,旗山區,圓富里,275,134,217,369,58,-235,26.728,-63.686
64000300005,高雄市,旗山區,中正里,253,70,216,239,37,-169,17.13,-70.711
64000300006,高雄市,旗山區,大林里,185,73,176,239,9,-166,5.114,-69.456
64000300007,高雄市,旗山區,上洲里,111,89,88,297,23,-208,26.136,-70.034
64000300008,高雄市,旗山區,新光里,137,55,119,200,18,-145,15.126,-72.5
64000300009,高雄市,旗山區,南勝里,257,214,234,605,23,-391,9.829,-64.628
64000300010,高雄市,旗山區,中寮里,23,23,22,45,1,-22,4.545,-48.889
64000300011,高雄市,旗山區,東平里,342,164,306,500,36,-336,11.765,-67.2
64000300012,高雄市,旗山區,東昌里,160,84,172,218,-12,-134,-6.977,-61.468
64000300013,高雄市,旗山區,竹峰里,250,137,247,320,3,-183,1.215,-57.188
64000300014,高雄市,旗山區,瑞吉里,338,187,283,472,55,-285,19.435,-60.381
64000300015,高雄市,旗山區,永和里,459,258,397,711,62,-453,15.617,-63.713
64000300016,高雄市,旗山區,三協里,384,157,311,522,73,-365,23.473,-69.923
64000300017,高雄市,旗山區,鯤洲里,73,88,61,265,12,-177,19.672,-66.792
64000300018,高雄市,旗山區,大山里,188,115,140,342,48,-227,34.286,-66.374
64000300019,高雄市,旗山區,中洲里,93,67,81,243,12,-176,14.815,-72.428
64000300020,高雄市,旗山區,南洲里,176,103,166,357,10,-254,6.024,-71.148
64000300021,高雄市,旗山區,廣福里,139,51,116,105,23,-54,19.828,-51.429
64000310001,高雄市,美濃區,福安里,506,219,451,533,55,-314,12.195,-58.912
64000310014,高雄市,美濃區,瀰濃里,456,155,358,434,98,-279,27.374,-64.286
64000310013,高雄市,美濃區,泰安里,384,113,310,300,74,-187,23.871,-62.333
64000310012,高雄市,美濃區,東門里,220,101,181,243,39,-142,21.547,-58.436
64000310011,高雄市,美濃區,中圳里,445,113,385,371,60,-258,15.584,-69.542
64000310002,高雄市,美濃區,合和里,514,153,445,387,69,-234,15.506,-60.465
64000310003,高雄市,美濃區,祿興里,570,172,499,473,71,-301,14.228,-63.636
64000310005,高雄市,美濃區,德興里,372,85,311,226,61,-141,19.614,-62.389
64000310004,高雄市,美濃區,中壇里,475,162,373,326,102,-164,27.346,-50.307
64000310015,高雄市,美濃區,清水里,357,123,324,337,33,-214,10.185,-63.501
64000310017,高雄市,美濃區,吉和里,248,133,258,235,-10,-102,-3.876,-43.404
64000310016,高雄市,美濃區,吉洋里,347,133,302,380,45,-247,14.901,-65.0
64000310018,高雄市,美濃區,吉東里,314,147,212,378,102,-231,48.113,-61.111
64000310006,高雄市,美濃區,龍山里,447,154,334,351,113,-197,33.832,-56.125
64000310007,高雄市,美濃區,獅山里,491,182,402,552,89,-370,22.139,-67.029
64000310008,高雄市,美濃區,龍肚里,290,111,244,290,46,-179,18.852,-61.724
64000310019,高雄市,美濃區,廣林里,252,101,234,278,18,-177,7.692,-63.669
64000310009,高雄市,美濃區,廣德里,234,86,203,266,31,-180,15.271,-67.669
64000310010,高雄市,美濃區,興隆里,204,86,180,248,24,-162,13.333,-65.323
64000360003,高雄市,茂林區,多納里,82,17,113,32,-31,-15,-27.434,-46.875
64000360002,高雄市,茂林區,萬山里,72,24,93,39,-21,-15,-22.581,-38.462
64000360001,高雄市,茂林區,茂林里,148,30,173,53,-25,-23,-14.451,-43.396
64000230001,高雄市,阿蓮區,石安里,174,120,127,359,47,-239,37.008,-66.574
64000230002,高雄市,阿蓮區,中路里,233,215,170,655,63,-440,37.059,-67.176
64000230003,高雄市,阿蓮區,峯山里,144,103,119,344,25,-241,21.008,-70.058
64000230004,高雄市,阿蓮區,港後里,362,174,339,531,23,-357,6.785,-67.232
64000230005,高雄市,阿蓮區,崗山里,114,43,101,173,13,-130,12.871,-75.145
64000230006,高雄市,阿蓮區,阿蓮里,721,393,572,1219,149,-826,26.049,-67.76
64000230007,高雄市,阿蓮區,清蓮里,364,224,281,674,83,-450,29.537,-66.766
64000230008,高雄市,阿蓮區,和蓮里,335,215,266,652,69,-437,25.94,-67.025
64000230009,高雄市,阿蓮區,青旗里,271,115,208,358,63,-243,30.288,-67.877
64000230010,高雄市,阿蓮區,復安里,241,150,209,421,32,-271,15.311,-64.371
64000230011,高雄市,阿蓮區,玉庫里,149,121,102,355,47,-234,46.078,-65.915
64000230012,高雄市,阿蓮區,南蓮里,461,215,439,693,22,-478,5.011,-68.975
64000220001,高雄市,田寮區,鹿埔里,80,19,52,89,28,-70,53.846,-78.652
64000220002,高雄市,田寮區,南安里,113,51,104,256,9,-205,8.654,-80.078
64000220003,高雄市,田寮區,大同里,29,45,27,115,2,-70,7.407,-60.87
64000220004,高雄市,田寮區,田寮里,31,23,28,100,3,-77,10.714,-77.0
64000220005,高雄市,田寮區,七星里,67,40,54,169,13,-129,24.074,-76.331
64000220006,高雄市,田寮區,崇德里,147,33,142,201,5,-168,3.521,-83.582
64000220007,高雄市,田寮區,西德里,125,49,90,164,35,-115,38.889,-70.122
64000220008,高雄市,田寮區,三和里,38,16,45,66,-7,-50,-15.556,-75.758
64000220009,高雄市,田寮區,古亭里,52,22,41,119,11,-97,26.829,-81.513
64000220010,高雄市,田寮區,新興里,136,82,112,341,24,-259,21.429,-75.953
64000210001,高雄市,燕巢區,尖山里,171,111,129,306,42,-195,32.558,-63.725
64000210002,高雄市,燕巢區,瓊林里,400,220,292,622,108,-402,36.986,-64.63
64000210003,高雄市,燕巢區,安招里,551,314,458,935,93,-621,20.306,-66.417
64000210004,高雄市,燕巢區,角宿里,563,273,421,721,142,-448,33.729,-62.136
64000210005,高雄市,燕巢區,鳳雄里,411,242,343,705,68,-463,19.825,-65.674
64000210006,高雄市,燕巢區,金山里,84,22,79,86,5,-64,6.329,-74.419
64000210007,高雄市,燕巢區,東燕里,359,179,289,580,70,-401,24.221,-69.138
64000210008,高雄市,燕巢區,南燕里,680,323,610,890,70,-567,11.475,-63.708
64000210009,高雄市,燕巢區,西燕里,545,287,443,835,102,-548,23.025,-65.629
64000210010,高雄市,燕巢區,橫山里,303,146,242,458,61,-312,25.207,-68.122
64000210011,高雄市,燕巢區,深水里,339,217,292,597,47,-380,16.096,-63.652
64000150001,高雄市,大樹區,竹寮里,493,265,414,706,79,-441,19.082,-62.465
64000150002,高雄市,大樹區,九曲里,913,479,729,1177,184,-698,25.24,-59.303
64000150003,高雄市,大樹區,久堂里,767,458,657,1075,110,-617,16.743,-57.395
64000150004,高雄市,大樹區,水安里,365,260,314,712,51,-452,16.242,-63.483
64000150005,高雄市,大樹區,水寮里,314,314,293,720,21,-406,7.167,-56.389
64000150006,高雄市,大樹區,檨腳里,516,340,416,931,100,-591,24.038,-63.48
64000150007,高雄市,大樹區,興山里,114,121,84,334,30,-213,35.714,-63.772
64000150008,高雄市,大樹區,和山里,157,85,104,302,53,-217,50.962,-71.854
64000150009,高雄市,大樹區,姑山里,138,117,332,103,-194,14,-58.434,13.592
64000150010,高雄市,大樹區,大坑里,198,148,164,402,34,-254,20.732,-63.184
64000150011,高雄市,大樹區,井腳里,177,183,140,513,37,-330,26.429,-64.327
64000150012,高雄市,大樹區,小坪里,207,145,171,391,36,-246,21.053,-62.916
64000150013,高雄市,大樹區,龍目里,187,238,135,628,52,-390,38.519,-62.102
64000150014,高雄市,大樹區,大樹里,336,236,257,739,79,-503,30.739,-68.065
64000150015,高雄市,大樹區,三和里,152,83,135,242,17,-159,12.593,-65.702
64000150016,高雄市,大樹區,溪埔里,172,169,161,465,11,-296,6.832,-63.656
64000150017,高雄市,大樹區,興田里,355,218,311,442,44,-224,14.148,-50.679
64000150018,高雄市,大樹區,統嶺里,101,70,84,181,17,-111,20.238,-61.326
64000160001,高雄市,大社區,嘉誠里,151,54,125,192,26,-138,20.8,-71.875
64000160002,高雄市,大社區,保社里,603,338,501,909,102,-571,20.359,-62.816
64000160003,高雄市,大社區,大社里,807,507,706,1338,101,-831,14.306,-62.108
64000160009,高雄市,大社區,保安里,530,365,385,926,145,-561,37.662,-60.583
64000160005,高雄市,大社區,三奶里,413,312,359,811,54,-499,15.042,-61.529
64000160006,高雄市,大社區,觀音里,840,662,735,1684,105,-1022,14.286,-60.689
64000160007,高雄市,大社區,神農里,815,456,647,1271,168,-815,25.966,-64.123
64000160008,高雄市,大社區,中里里,551,342,428,902,123,-560,28.738,-62.084
64000160004,高雄市,大社區,翠屏里,250,209,197,495,53,-286,26.904,-57.778
64000260001,高雄市,茄萣區,福德里,117,99,100,319,17,-220,17.0,-68.966
64000260002,高雄市,茄萣區,萬福里,98,71,104,230,-6,-159,-5.769,-69.13
64000260003,高雄市,茄萣區,白雲里,286,152,248,433,38,-281,15.323,-64.896
64000260004,高雄市,茄萣區,嘉賜里,603,358,442,1009,161,-651,36.425,-64.519
64000260005,高雄市,茄萣區,嘉安里,247,195,228,440,19,-245,8.333,-55.682
64000260011,高雄市,茄萣區,嘉樂里,322,171,257,507,65,-336,25.292,-66.272
64000260012,高雄市,茄萣區,嘉泰里,162,104,100,281,62,-177,62.0,-62.989
64000260013,高雄市,茄萣區,嘉福里,138,67,106,207,32,-140,30.189,-67.633
64000260014,高雄市,茄萣區,和協里,154,103,136,322,18,-219,13.235,-68.012
64000260006,高雄市,茄萣區,嘉定里,128,96,102,317,26,-221,25.49,-69.716
64000260007,高雄市,茄萣區,保定里,441,252,326,792,115,-540,35.276,-68.182
64000260009,高雄市,茄萣區,大定里,171,74,119,222,52,-148,43.697,-66.667
64000260008,高雄市,茄萣區,光定里,135,73,101,203,34,-130,33.663,-64.039
64000260010,高雄市,茄萣區,吉定里,150,118,110,324,40,-206,36.364,-63.58
64000260015,高雄市,茄萣區,崎漏里,709,367,622,1036,87,-669,13.987,-64.575
64000250001,高雄市,湖內區,海山里,179,95,162,315,17,-220,10.494,-69.841
64000250002,高雄市,湖內區,劉家里,130,102,121,272,9,-170,7.438,-62.5
64000250003,高雄市,湖內區,太爺里,133,76,96,258,37,-182,38.542,-70.543
64000250004,高雄市,湖內區,公舘里,396,177,303,551,93,-374,30.693,-67.877
64000250005,高雄市,湖內區,葉厝里,365,277,270,754,95,-477,35.185,-63.263
64000250006,高雄市,湖內區,大湖里,673,304,538,901,135,-597,25.093,-66.26
64000250007,高雄市,湖內區,田尾里,199,97,145,254,54,-157,37.241,-61.811
64000250008,高雄市,湖內區,湖內里,729,323,561,917,168,-594,29.947,-64.776
64000250009,高雄市,湖內區,海埔里,231,152,191,525,40,-373,20.942,-71.048
64000250010,高雄市,湖內區,文賢里,196,126,144,338,52,-212,36.111,-62.722
64000250011,高雄市,湖內區,中賢里,281,185,203,563,78,-378,38.424,-67.14
64000250012,高雄市,湖內區,逸賢里,153,75,117,310,36,-235,30.769,-75.806
64000250013,高雄市,湖內區,忠興里,95,54,87,188,8,-134,9.195,-71.277
64000250014,高雄市,湖內區,湖東里,512,194,377,560,135,-366,35.809,-65.357
64000240001,高雄市,路竹區,竹滬里,548,241,410,742,138,-501,33.659,-67.52
64000240002,高雄市,路竹區,頂寮里,182,70,173,296,9,-226,5.202,-76.351
64000240003,高雄市,路竹區,新達里,235,77,158,282,77,-205,48.734,-72.695
64000240004,高雄市,路竹區,後鄉里,172,86,145,288,27,-202,18.621,-70.139
64000240005,高雄市,路竹區,北嶺里,210,133,195,372,15,-239,7.692,-64.247
64000240006,高雄市,路竹區,社西里,392,202,340,558,52,-356,15.294,-63.799
64000240007,高雄市,路竹區,甲北里,373,180,277,541,96,-361,34.657,-66.728
64000240008,高雄市,路竹區,甲南里,583,242,502,697,81,-455,16.135,-65.28
64000240009,高雄市,路竹區,下坑里,442,198,295,671,147,-473,49.831,-70.492
64000240010,高雄市,路竹區,竹園里,263,158,190,462,73,-304,38.421,-65.801
64000240011,高雄市,路竹區,竹東里,648,302,530,847,118,-545,22.264,-64.345
64000240012,高雄市,路竹區,竹西里,416,175,332,537,84,-362,25.301,-67.412
64000240013,高雄市,路竹區,文北里,572,253,412,736,160,-483,38.835,-65.625
64000240014,高雄市,路竹區,文南里,433,202,398,614,35,-412,8.794,-67.101
64000240015,高雄市,路竹區,三爺里,148,73,114,243,34,-170,29.825,-69.959
64000240016,高雄市,路竹區,鴨寮里,372,187,281,490,91,-303,32.384,-61.837
64000240017,高雄市,路竹區,社東里,293,171,210,473,83,-302,39.524,-63.848
64000240018,高雄市,路竹區,社中里,143,74,103,228,40,-154,38.835,-67.544
64000240019,高雄市,路竹區,竹南里,462,271,452,713,10,-442,2.212,-61.992
64000240020,高雄市,路竹區,社南里,891,396,715,1098,176,-702,24.615,-63.934
64000270001,高雄市,永安區,永安里,262,115,252,385,10,-270,3.968,-70.13
64000270002,高雄市,永安區,永華里,313,137,271,466,42,-329,15.498,-70.601
64000270003,高雄市,永安區,新港里,291,160,285,598,6,-438,2.105,-73.244
64000270004,高雄市,永安區,鹽田里,47,50,37,102,10,-52,27.027,-50.98
64000270005,高雄市,永安區,保寧里,417,151,377,572,40,-421,10.61,-73.601
64000270006,高雄市,永安區,維新里,494,276,415,839,79,-563,19.036,-67.104
64000190002,高雄市,岡山區,岡山里,711,379,637,1037,74,-658,11.617,-63.452
64000190003,高雄市,岡山區,壽天里,583,273,651,788,-68,-515,-10.445,-65.355
64000190001,高雄市,岡山區,平安里,204,100,194,276,10,-176,5.155,-63.768
64000190004,高雄市,岡山區,維仁里,155,98,144,271,11,-173,7.639,-63.838
64000190006,高雄市,岡山區,大遼里,185,184,165,469,20,-285,12.121,-60.768
64000190018,高雄市,岡山區,程香里,952,330,771,941,181,-611,23.476,-64.931
64000190005,高雄市,岡山區,後紅里,949,323,801,893,148,-570,18.477,-63.83
64000190017,高雄市,岡山區,碧紅里,668,349,613,929,55,-580,8.972,-62.433
64000190019,高雄市,岡山區,竹圍里,1271,569,1019,1638,252,-1069,24.73,-65.263
64000190020,高雄市,岡山區,台上里,1044,520,842,1471,202,-951,23.99,-64.65
64000190031,高雄市,岡山區,為隨里,121,92,89,200,32,-108,35.955,-54.0
64000190021,高雄市,岡山區,灣裡里,347,202,273,498,74,-296,27.106,-59.438
64000190025,高雄市,岡山區,本洲里,266,178,219,459,47,-281,21.461,-61.22
64000190009,高雄市,岡山區,前峰里,541,233,443,738,98,-505,22.122,-68.428
64000190032,高雄市,岡山區,壽峰里,417,220,423,542,-6,-322,-1.418,-59.41
64000190016,高雄市,岡山區,仁壽里,616,307,630,872,-14,-565,-2.222,-64.794
64000190012,高雄市,岡山區,後協里,1170,454,1040,1183,130,-729,12.5,-61.623
64000190011,高雄市,岡山區,協和里,675,321,669,943,6,-622,0.897,-65.96
64000190030,高雄市,岡山區,協榮里,462,165,449,420,13,-255,2.895,-60.714
64000190010,高雄市,岡山區,劉厝里,258,173,222,484,36,-311,16.216,-64.256
64000190022,高雄市,岡山區,白米里,421,208,299,485,122,-277,40.803,-57.113
64000190023,高雄市,岡山區,石潭里,333,209,326,564,7,-355,2.147,-62.943
64000190024,高雄市,岡山區,福興里,222,118,176,296,46,-178,26.136,-60.135
64000190026,高雄市,岡山區,嘉興里,482,360,388,1007,94,-647,24.227,-64.25
64000190027,高雄市,岡山區,嘉峰里,307,129,284,490,23,-361,8.099,-73.673
64000190014,高雄市,岡山區,潭底里,113,93,83,254,30,-161,36.145,-63.386
64000190028,高雄市,岡山區,華崗里,181,199,143,607,38,-408,26.573,-67.216
64000190015,高雄市,岡山區,三和里,116,78,81,283,35,-205,43.21,-72.438
64000190029,高雄市,岡山區,大莊里,186,72,134,227,52,-155,38.806,-68.282
64000190007,高雄市,岡山區,忠孝里,998,140,1021,297,-23,-157,-2.253,-52.862
64000190033,高雄市,岡山區,仁義里,760,51,864,116,-104,-65,-12.037,-56.034
64000190013,高雄市,岡山區,信義里,406,88,368,290,38,-202,10.326,-69.655
64000190008,高雄市,岡山區,和平里,113,60,71,81,42,-21,59.155,-25.926
64000280001,高雄市,彌陀區,光和里,174,131,165,335,9,-204,5.455,-60.896
64000280002,高雄市,彌陀區,彌靖里,363,146,293,486,70,-340,23.891,-69.959
64000280003,高雄市,彌陀區,彌仁里,92,61,97,113,-5,-52,-5.155,-46.018
64000280004,高雄市,彌陀區,彌壽里,171,57,152,189,19,-132,12.5,-69.841
64000280005,高雄市,彌陀區,彌陀里,364,141,310,427,54,-286,17.419,-66.979
64000280006,高雄市,彌陀區,舊港里,243,107,250,371,-7,-264,-2.8,-71.159
64000280007,高雄市,彌陀區,文安里,272,139,226,442,46,-303,20.354,-68.552
64000280009,高雄市,彌陀區,過港里,167,81,136,220,31,-139,22.794,-63.182
64000280008,高雄市,彌陀區,鹽埕里,353,155,297,506,56,-351,18.855,-69.368
64000280010,高雄市,彌陀區,海尾里,165,48,120,175,45,-127,37.5,-72.571
64000280011,高雄市,彌陀區,漯底里,226,86,203,249,23,-163,11.33,-65.462
64000280012,高雄市,彌陀區,南寮里,363,145,296,502,67,-357,22.635,-71.116
64000290001,高雄市,梓官區,梓信里,346,277,252,660,94,-383,37.302,-58.03
64000290002,高雄市,梓官區,梓義里,309,233,255,573,54,-340,21.176,-59.337
64000290003,高雄市,梓官區,梓和里,375,304,322,770,53,-466,16.46,-60.519
64000290004,高雄市,梓官區,梓平里,264,171,183,475,81,-304,44.262,-64.0
64000290005,高雄市,梓官區,中崙里,193,127,180,380,13,-253,7.222,-66.579
64000290010,高雄市,梓官區,同安里,172,97,117,270,55,-173,47.009,-64.074
64000290011,高雄市,梓官區,大舍里,598,393,460,1067,138,-674,30.0,-63.168
64000290006,高雄市,梓官區,赤崁里,245,207,218,544,27,-337,12.385,-61.949
64000290012,高雄市,梓官區,赤東里,305,209,238,673,67,-464,28.151,-68.945
64000290013,高雄市,梓官區,赤西里,128,61,122,219,6,-158,4.918,-72.146
64000290007,高雄市,梓官區,禮蚵里,243,192,196,601,47,-409,23.98,-68.053
64000290008,高雄市,梓官區,智蚵里,478,261,363,759,115,-498,31.68,-65.613
64000290009,高雄市,梓官區,信蚵里,420,228,309,564,111,-336,35.922,-59.574
64000290014,高雄市,梓官區,茄苳里,405,211,309,601,96,-390,31.068,-64.892
64000290015,高雄市,梓官區,典寶里,536,314,472,824,64,-510,13.559,-61.893
64000200001,高雄市,橋頭區,橋頭里,423,239,344,600,79,-361,22.965,-60.167
64000200002,高雄市,橋頭區,橋南里,171,168,161,379,10,-211,6.211,-55.673
64000200003,高雄市,橋頭區,仕隆里,359,318,339,791,20,-473,5.9,-59.798
64000200004,高雄市,橋頭區,仕豐里,505,335,464,788,41,-453,8.836,-57.487
64000200005,高雄市,橋頭區,芋寮里,226,158,169,392,57,-234,33.728,-59.694
64000200006,高雄市,橋頭區,東林里,345,351,277,797,68,-446,24.549,-55.96
64000200007,高雄市,橋頭區,西林里,187,194,154,497,33,-303,21.429,-60.966
64000200008,高雄市,橋頭區,白樹里,620,393,496,945,124,-552,25.0,-58.413
64000200009,高雄市,橋頭區,筆秀里,249,211,201,526,48,-315,23.881,-59.886
64000200010,高雄市,橋頭區,新莊里,1286,541,707,1159,579,-618,81.895,-53.322
64000200011,高雄市,橋頭區,甲北里,554,334,306,625,248,-291,81.046,-46.56
64000200012,高雄市,橋頭區,甲南里,415,309,333,739,82,-430,24.625,-58.187
64000200013,高雄市,橋頭區,頂鹽里,229,174,187,406,42,-232,22.46,-57.143
64000200014,高雄市,橋頭區,中崎里,81,92,61,222,20,-130,32.787,-58.559
64000200015,高雄市,橋頭區,仕和里,646,525,549,1216,97,-691,17.668,-56.826
64000200016,高雄市,橋頭區,德松里,319,188,209,456,110,-268,52.632,-58.772
64000200017,高雄市,橋頭區,三德里,95,136,77,277,18,-141,23.377,-50.903
64000040001,高雄市,楠梓區,清豐里,4215,2253,3297,5371,918,-3118,27.843,-58.053
64000040002,高雄市,楠梓區,東寧里,826,449,666,1091,160,-642,24.024,-58.845
64000040003,高雄市,楠梓區,五常里,939,568,847,1511,92,-943,10.862,-62.409
64000040004,高雄市,楠梓區,享平里,465,271,443,830,22,-559,4.966,-67.349
64000040006,高雄市,楠梓區,惠楠里,413,234,388,656,25,-422,6.443,-64.329
64000040005,高雄市,楠梓區,中陽里,454,369,406,925,48,-556,11.823,-60.108
64000040007,高雄市,楠梓區,惠民里,981,511,674,1064,307,-553,45.549,-51.974
64000040008,高雄市,楠梓區,惠豐里,1092,409,991,1025,101,-616,10.192,-60.098
64000040009,高雄市,楠梓區,錦屏里,363,393,340,1015,23,-622,6.765,-61.281
64000040010,高雄市,楠梓區,玉屏里,256,372,218,805,38,-433,17.431,-53.789
64000040011,高雄市,楠梓區,金田里,720,508,460,1209,260,-701,56.522,-57.982
64000040012,高雄市,楠梓區,稔田里,166,208,151,566,15,-358,9.934,-63.251
64000040013,高雄市,楠梓區,瑞屏里,654,341,527,872,127,-531,24.099,-60.894
64000040014,高雄市,楠梓區,翠屏里,3247,1054,3107,2984,140,-1930,4.506,-64.678
64000040015,高雄市,楠梓區,宏南里,168,53,191,165,-23,-112,-12.042,-67.879
64000040016,高雄市,楠梓區,宏毅里,376,224,465,590,-89,-366,-19.14,-62.034
64000040017,高雄市,楠梓區,宏榮里,537,237,548,534,-11,-297,-2.007,-55.618
64000040018,高雄市,楠梓區,廣昌里,584,291,569,700,15,-409,2.636,-58.429
64000040019,高雄市,楠梓區,久昌里,552,245,483,582,69,-337,14.286,-57.904
64000040020,高雄市,楠梓區,大昌里,403,176,346,426,57,-250,16.474,-58.685
64000040021,高雄市,楠梓區,福昌里,444,258,357,605,87,-347,24.37,-57.355
64000040022,高雄市,楠梓區,盛昌里,1126,440,1128,1188,-2,-748,-0.177,-62.963
64000040023,高雄市,楠梓區,泰昌里,216,122,217,347,-1,-225,-0.461,-64.841
64000040024,高雄市,楠梓區,興昌里,796,411,732,1076,64,-665,8.743,-61.803
64000040025,高雄市,楠梓區,建昌里,460,222,491,580,-31,-358,-6.314,-61.724
64000040026,高雄市,楠梓區,宏昌里,679,302,650,744,29,-442,4.462,-59.409
64000040027,高雄市,楠梓區,和昌里,411,160,415,473,-4,-313,-0.964,-66.173
64000040028,高雄市,楠梓區,慶昌里,672,323,740,793,-68,-470,-9.189,-59.269
64000040029,高雄市,楠梓區,隆昌里,589,290,646,742,-57,-452,-8.824,-60.916
64000040030,高雄市,楠梓區,秀昌里,431,157,475,474,-44,-317,-9.263,-66.878
64000040031,高雄市,楠梓區,裕昌里,825,430,768,1081,57,-651,7.422,-60.222
64000040032,高雄市,楠梓區,國昌里,616,304,603,827,13,-523,2.156,-63.241
64000040033,高雄市,楠梓區,加昌里,1779,616,1715,1635,64,-1019,3.732,-62.324
64000040034,高雄市,楠梓區,仁昌里,1156,348,973,961,183,-613,18.808,-63.788
64000040035,高雄市,楠梓區,藍田里,1884,752,1288,1687,596,-935,46.273,-55.424
64000040036,高雄市,楠梓區,中興里,420,248,217,478,203,-230,93.548,-48.117
64000040037,高雄市,楠梓區,中和里,976,491,493,942,483,-451,97.972,-47.877
64000030001,高雄市,左營區,進學里,264,126,315,332,-51,-206,-16.19,-62.048
64000030002,高雄市,左營區,尾西里,152,172,151,325,1,-153,0.662,-47.077
64000030003,高雄市,左營區,頂北里,88,60,98,173,-10,-113,-10.204,-65.318
64000030004,高雄市,左營區,中北里,73,85,63,237,10,-152,15.873,-64.135
64000030005,高雄市,左營區,中南里,41,75,63,181,-22,-106,-34.921,-58.564
64000030006,高雄市,左營區,廟東里,107,135,87,322,20,-187,22.989,-58.075
64000030007,高雄市,左營區,廟北里,87,135,97,307,-10,-172,-10.309,-56.026
64000030008,高雄市,左營區,尾南里,86,102,80,246,6,-144,7.5,-58.537
64000030009,高雄市,左營區,尾北里,514,357,530,871,-16,-514,-3.019,-59.013
64000030011,高雄市,左營區,屏山里,353,47,444,194,-91,-147,-20.495,-75.773
64000030012,高雄市,左營區,祥和里,101,14,113,35,-12,-21,-10.619,-60.0
64000030013,高雄市,左營區,永清里,198,56,133,56,65,0,48.872,0.0
64000030015,高雄市,左營區,莒光里,386,112,445,286,-59,-174,-13.258,-60.839
64000030016,高雄市,左營區,光輝里,504,176,522,510,-18,-334,-3.448,-65.49
64000030017,高雄市,左營區,合群里,1032,73,1109,133,-77,-60,-6.943,-45.113
64000030019,高雄市,左營區,明建里,212,50,200,88,12,-38,6.0,-43.182
64000030021,高雄市,左營區,頂西里,108,167,100,343,8,-176,8.0,-51.312
64000030022,高雄市,左營區,聖后里,102,122,102,265,0,-143,0.0,-53.962
64000030023,高雄市,左營區,聖西里,53,40,46,109,7,-69,15.217,-63.303
64000030024,高雄市,左營區,聖南里,75,85,76,177,-1,-92,-1.316,-51.977
64000030025,高雄市,左營區,城南里,64,60,65,176,-1,-116,-1.538,-65.909
64000030026,高雄市,左營區,路東里,121,96,114,252,7,-156,6.14,-61.905
64000030027,高雄市,左營區,廍北里,46,77,35,159,11,-82,31.429,-51.572
64000030028,高雄市,左營區,廍南里,84,100,92,201,-8,-101,-8.696,-50.249
64000030029,高雄市,左營區,埤西里,157,106,154,251,3,-145,1.948,-57.769
64000030030,高雄市,左營區,埤北里,274,86,334,223,-60,-137,-17.964,-61.435
64000030031,高雄市,左營區,埤東里,148,97,157,258,-9,-161,-5.732,-62.403
64000030032,高雄市,左營區,海勝里,1968,200,2179,524,-211,-324,-9.683,-61.832
64000030034,高雄市,左營區,崇實里,899,256,778,574,121,-318,15.553,-55.401
64000030035,高雄市,左營區,自助里,521,205,205,161,316,44,154.146,27.329
64000030036,高雄市,左營區,果貿里,914,98,985,279,-71,-181,-7.208,-64.875
64000030037,高雄市,左營區,果惠里,467,61,534,161,-67,-100,-12.547,-62.112
64000030038,高雄市,左營區,果峰里,452,57,524,138,-72,-81,-13.74,-58.696
64000030039,高雄市,左營區,新下里,2898,1252,2856,3040,42,-1788,1.471,-58.816
64000030040,高雄市,左營區,新上里,4702,2381,4619,6278,83,-3897,1.797,-62.074
64000030041,高雄市,左營區,新中里,694,551,644,1535,50,-984,7.764,-64.104
64000030042,高雄市,左營區,新光里,2712,1226,2620,3135,92,-1909,3.511,-60.893
64000030043,高雄市,左營區,菜公里,5588,2359,5218,6334,370,-3975,7.091,-62.757
64000030044,高雄市,左營區,福山里,7036,2757,6594,7174,442,-4417,6.703,-61.57
64000170001,高雄市,仁武區,大灣里,821,516,640,1196,181,-680,28.281,-56.856
64000170002,高雄市,仁武區,灣內里,1455,780,1130,2021,325,-1241,28.761,-61.405
64000170003,高雄市,仁武區,考潭里,456,286,473,743,-17,-457,-3.594,-61.507
64000170004,高雄市,仁武區,烏林里,543,271,479,886,64,-615,13.361,-69.413
64000170005,高雄市,仁武區,仁福里,104,61,107,221,-3,-160,-2.804,-72.398
64000170006,高雄市,仁武區,仁武里,822,535,637,1398,185,-863,29.042,-61.731
64000170007,高雄市,仁武區,文武里,1599,916,1272,2495,327,-1579,25.708,-63.287
64000170008,高雄市,仁武區,竹後里,282,310,221,798,61,-488,27.602,-61.153
64000170009,高雄市,仁武區,八卦里,3737,1820,2778,4268,959,-2448,34.521,-57.357
64000170010,高雄市,仁武區,高楠里,625,349,387,702,238,-353,61.499,-50.285
64000170011,高雄市,仁武區,後安里,403,265,271,794,132,-529,48.708,-66.625
64000170012,高雄市,仁武區,中華里,285,148,264,382,21,-234,7.955,-61.257
64000170013,高雄市,仁武區,五和里,993,514,709,1290,284,-776,40.056,-60.155
64000170014,高雄市,仁武區,仁和里,685,395,643,1059,42,-664,6.532,-62.701
64000170015,高雄市,仁武區,赤山里,1373,698,1111,1736,262,-1038,23.582,-59.793
64000170016,高雄市,仁武區,仁慈里,445,257,418,644,27,-387,6.459,-60.093
64000180001,高雄市,鳥松區,鳥松里,1861,967,1739,2683,122,-1716,7.016,-63.958
64000180002,高雄市,鳥松區,夢裡里,1013,497,935,1375,78,-878,8.342,-63.855
64000180003,高雄市,鳥松區,大華里,2101,1095,2084,2727,17,-1632,0.816,-59.846
64000180004,高雄市,鳥松區,坔埔里,581,401,545,1086,36,-685,6.606,-63.076
64000180005,高雄市,鳥松區,仁美里,1062,755,827,1922,235,-1167,28.416,-60.718
64000180006,高雄市,鳥松區,大竹里,119,108,95,242,24,-134,25.263,-55.372
64000180007,高雄市,鳥松區,華美里,698,426,614,1119,84,-693,13.681,-61.93
64000140001,高雄市,大寮區,拷潭里,171,193,154,436,17,-243,11.039,-55.734
64000140002,高雄市,大寮區,內坑里,950,546,794,1309,156,-763,19.647,-58.289
64000140003,高雄市,大寮區,大寮里,1028,622,736,1650,292,-1028,39.674,-62.303
64000140004,高雄市,大寮區,上寮里,365,285,257,730,108,-445,42.023,-60.959
64000140005,高雄市,大寮區,三隆里,772,486,596,1275,176,-789,29.53,-61.882
64000140006,高雄市,大寮區,琉球里,871,591,567,1408,304,-817,53.616,-58.026
64000140007,高雄市,大寮區,翁園里,628,532,434,1318,194,-786,44.7,-59.636
64000140008,高雄市,大寮區,前庄里,455,251,439,644,16,-393,3.645,-61.025
64000140009,高雄市,大寮區,中庄里,1841,1104,1419,2767,422,-1663,29.739,-60.101
64000140010,高雄市,大寮區,後庄里,1405,784,1225,1859,180,-1075,14.694,-57.827
64000140011,高雄市,大寮區,義仁里,257,193,207,542,50,-349,24.155,-64.391
64000140012,高雄市,大寮區,新厝里,246,153,175,420,71,-267,40.571,-63.571
64000140013,高雄市,大寮區,過溪里,414,209,327,671,87,-462,26.606,-68.852
64000140014,高雄市,大寮區,潮寮里,375,325,308,877,67,-552,21.753,-62.942
64000140015,高雄市,大寮區,會結里,235,153,194,397,41,-244,21.134,-61.461
64000140016,高雄市,大寮區,會社里,1038,538,987,1352,51,-814,5.167,-60.207
64000140017,高雄市,大寮區,山頂里,1443,541,1437,1533,6,-992,0.418,-64.71
64000140018,高雄市,大寮區,忠義里,101,26,152,93,-51,-67,-33.553,-72.043
64000140019,高雄市,大寮區,永芳里,1168,760,991,1775,177,-1015,17.861,-57.183
64000140020,高雄市,大寮區,義和里,390,310,265,692,125,-382,47.17,-55.202
64000140021,高雄市,大寮區,溪寮里,269,196,216,461,53,-265,24.537,-57.484
64000140022,高雄市,大寮區,江山里,342,267,255,570,87,-303,34.118,-53.158
64000140023,高雄市,大寮區,昭明里,575,375,393,1005,182,-630,46.31,-62.687
64000140025,高雄市,大寮區,中興里,1572,418,1642,1109,-70,-691,-4.263,-62.308
64000130001,高雄市,林園區,東林里,406,260,327,693,79,-433,24.159,-62.482
64000130002,高雄市,林園區,林園里,492,303,432,816,60,-513,13.889,-62.868
64000130003,高雄市,林園區,溪州里,684,408,478,1062,206,-654,43.096,-61.582
64000130004,高雄市,林園區,潭頭里,416,240,394,667,22,-427,5.584,-64.018
64000130005,高雄市,林園區,中厝里,502,273,478,755,24,-482,5.021,-63.841
64000130006,高雄市,林園區,中門里,400,278,329,654,71,-376,21.581,-57.492
64000130007,高雄市,林園區,頂厝里,706,468,528,1243,178,-775,33.712,-62.349
64000130008,高雄市,林園區,港埔里,240,189,198,556,42,-367,21.212,-66.007
64000130009,高雄市,林園區,西溪里,408,389,294,1003,114,-614,38.776,-61.216
64000130010,高雄市,林園區,港嘴里,222,223,171,537,51,-314,29.825,-58.473
64000130011,高雄市,林園區,北汕里,238,142,189,337,49,-195,25.926,-57.864
64000130012,高雄市,林園區,林內里,348,183,312,403,36,-220,11.538,-54.591
64000130013,高雄市,林園區,王公里,655,446,559,1056,96,-610,17.174,-57.765
64000130014,高雄市,林園區,林家里,211,131,154,326,57,-195,37.013,-59.816
64000130015,高雄市,林園區,龔厝里,352,220,247,605,105,-385,42.51,-63.636
64000130016,高雄市,林園區,鳳芸里,212,226,164,549,48,-323,29.268,-58.834
64000130017,高雄市,林園區,中芸里,203,221,151,540,52,-319,34.437,-59.074
64000130018,高雄市,林園區,東汕里,100,81,90,228,10,-147,11.111,-64.474
64000130019,高雄市,林園區,西汕里,74,83,55,209,19,-126,34.545,-60.287
64000130020,高雄市,林園區,仁愛里,422,310,362,840,60,-530,16.575,-63.095
64000130021,高雄市,林園區,文賢里,426,224,393,619,33,-395,8.397,-63.813
64000130022,高雄市,林園區,廣應里,569,384,429,909,140,-525,32.634,-57.756
64000130023,高雄市,林園區,五福里,360,206,269,580,91,-374,33.829,-64.483
64000130024,高雄市,林園區,中汕里,190,203,150,616,40,-413,26.667,-67.045
64000050001,高雄市,三民區,鼎金里,566,370,543,1005,23,-635,4.236,-63.184
64000050002,高雄市,三民區,鼎盛里,1243,686,1196,1821,47,-1135,3.93,-62.328
64000050003,高雄市,三民區,鼎強里,570,394,569,1056,1,-662,0.176,-62.689
64000050004,高雄市,三民區,鼎力里,629,364,639,1058,-10,-694,-1.565,-65.595
64000050005,高雄市,三民區,鼎西里,1136,672,1022,1818,114,-1146,11.155,-63.036
64000050006,高雄市,三民區,鼎中里,601,480,499,1089,102,-609,20.441,-55.923
64000050007,高雄市,三民區,鼎泰里,4352,1799,4121,5067,231,-3268,5.605,-64.496
64000050008,高雄市,三民區,本館里,1543,839,1347,2188,196,-1349,14.551,-61.654
64000050009,高雄市,三民區,本和里,1287,762,1185,1845,102,-1083,8.608,-58.699
64000050010,高雄市,三民區,本文里,326,215,319,548,7,-333,2.194,-60.766
64000050011,高雄市,三民區,本武里,267,206,229,482,38,-276,16.594,-57.261
64000050012,高雄市,三民區,本元里,922,523,864,1327,58,-804,6.713,-60.588
64000050013,高雄市,三民區,本安里,840,423,810,1113,30,-690,3.704,-61.995
64000050014,高雄市,三民區,本上里,828,413,866,1112,-38,-699,-4.388,-62.86
64000050015,高雄市,三民區,本揚里,1358,743,1327,1901,31,-1158,2.336,-60.915
64000050016,高雄市,三民區,寶獅里,660,382,638,984,22,-602,3.448,-61.179
64000050017,高雄市,三民區,寶德里,803,576,774,1304,29,-728,3.747,-55.828
64000050018,高雄市,三民區,寶泰里,632,360,552,973,80,-613,14.493,-63.001
64000050019,高雄市,三民區,寶興里,1119,711,1022,1715,97,-1004,9.491,-58.542
64000050020,高雄市,三民區,寶中里,407,276,435,788,-28,-512,-6.437,-64.975
64000050021,高雄市,三民區,寶華里,613,258,600,751,13,-493,2.167,-65.646
64000050022,高雄市,三民區,寶國里,1374,725,1288,1904,86,-1179,6.677,-61.922
64000050023,高雄市,三民區,寶民里,502,243,514,710,-12,-467,-2.335,-65.775
64000050024,高雄市,三民區,寶慶里,445,223,421,661,24,-438,5.701,-66.263
64000050025,高雄市,三民區,寶業里,1144,576,1000,1426,144,-850,14.4,-59.607
64000050026,高雄市,三民區,寶盛里,905,504,942,1320,-37,-816,-3.928,-61.818
64000050027,高雄市,三民區,寶安里,1280,570,1222,1580,58,-1010,4.746,-63.924
64000050028,高雄市,三民區,寶龍里,782,393,738,1150,44,-757,5.962,-65.826
64000050029,高雄市,三民區,寶珠里,827,486,864,1395,-37,-909,-4.282,-65.161
64000050030,高雄市,三民區,寶玉里,1392,750,1348,1939,44,-1189,3.264,-61.32
64000050031,高雄市,三民區,灣子里,662,386,603,906,59,-520,9.784,-57.395
64000050032,高雄市,三民區,灣愛里,404,276,336,676,68,-400,20.238,-59.172
64000050033,高雄市,三民區,灣中里,706,456,709,1318,-3,-862,-0.423,-65.402
64000050034,高雄市,三民區,灣華里,349,228,388,660,-39,-432,-10.052,-65.455
64000050035,高雄市,三民區,灣勝里,255,228,208,562,47,-334,22.596,-59.431
64000050036,高雄市,三民區,灣利里,386,419,388,1039,-2,-620,-0.515,-59.673
64000050037,高雄市,三民區,灣復里,613,410,523,855,90,-445,17.208,-52.047
64000050038,高雄市,三民區,正興里,2064,1017,1960,2767,104,-1750,5.306,-63.245
64000050039,高雄市,三民區,正順里,624,368,645,1033,-21,-665,-3.256,-64.376
64000050040,高雄市,三民區,灣興里,282,174,264,537,18,-363,6.818,-67.598
64000050041,高雄市,三民區,灣成里,489,260,393,620,96,-360,24.427,-58.065
64000050042,高雄市,三民區,安康里,317,244,343,683,-26,-439,-7.58,-64.275
64000050043,高雄市,三民區,安寧里,239,203,265,506,-26,-303,-9.811,-59.881
64000050044,高雄市,三民區,安吉里,857,449,748,1104,109,-655,14.572,-59.33
64000050045,高雄市,三民區,安發里,693,429,743,1167,-50,-738,-6.729,-63.239
64000050046,高雄市,三民區,安東里,530,393,472,940,58,-547,12.288,-58.191
64000050047,高雄市,三民區,安和里,429,379,363,795,66,-416,18.182,-52.327
64000050048,高雄市,三民區,達德里,174,161,194,449,-20,-288,-10.309,-64.143
64000050049,高雄市,三民區,達明里,241,223,237,482,4,-259,1.688,-53.734
64000050050,高雄市,三民區,達仁里,225,164,217,445,8,-281,3.687,-63.146
64000050051,高雄市,三民區,達勇里,168,94,139,265,29,-171,20.863,-64.528
64000050052,高雄市,三民區,同德里,462,346,479,826,-17,-480,-3.549,-58.111
64000050053,高雄市,三民區,德智里,405,264,383,605,22,-341,5.744,-56.364
64000050054,高雄市,三民區,德仁里,297,211,312,557,-15,-346,-4.808,-62.118
64000050055,高雄市,三民區,安生里,265,217,210,485,55,-268,26.19,-55.258
64000050056,高雄市,三民區,德東里,109,104,129,266,-20,-162,-15.504,-60.902
64000050057,高雄市,三民區,德行里,187,162,193,377,-6,-215,-3.109,-57.029
64000050058,高雄市,三民區,精華里,254,206,243,454,11,-248,4.527,-54.626
64000050059,高雄市,三民區,民享里,319,289,333,673,-14,-384,-4.204,-57.058
64000050060,高雄市,三民區,安宜里,538,371,482,984,56,-613,11.618,-62.297
64000050061,高雄市,三民區,安泰里,634,404,614,1041,20,-637,3.257,-61.191
64000050062,高雄市,三民區,安邦里,607,492,586,1135,21,-643,3.584,-56.652
64000050063,高雄市,三民區,十全里,247,172,230,524,17,-352,7.391,-67.176
64000050064,高雄市,三民區,十美里,266,233,281,551,-15,-318,-5.338,-57.713
64000050065,高雄市,三民區,德北里,459,246,354,579,105,-333,29.661,-57.513
64000050066,高雄市,三民區,立誠里,122,101,102,234,20,-133,19.608,-56.838
64000050067,高雄市,三民區,立業里,100,110,114,270,-14,-160,-12.281,-59.259
64000050068,高雄市,三民區,港東里,201,153,192,399,9,-246,4.688,-61.654
64000050069,高雄市,三民區,港新里,277,165,249,381,28,-216,11.245,-56.693
64000050070,高雄市,三民區,港西里,98,63,122,207,-24,-144,-19.672,-69.565
64000050072,高雄市,三民區,博愛里,195,143,216,325,-21,-182,-9.722,-56.0
64000050073,高雄市,三民區,博惠里,677,418,688,1147,-11,-729,-1.599,-63.557
64000050074,高雄市,三民區,長明里,169,79,184,241,-15,-162,-8.152,-67.22
64000050075,高雄市,三民區,建東里,216,94,193,253,23,-159,11.917,-62.846
64000050076,高雄市,三民區,興德里,378,218,359,504,19,-286,5.292,-56.746
64000050077,高雄市,三民區,鳳南里,153,116,127,329,26,-213,20.472,-64.742
64000050078,高雄市,三民區,鳳北里,186,196,209,447,-23,-251,-11.005,-56.152
64000050079,高雄市,三民區,德西里,403,174,163,264,240,-90,147.239,-34.091
64000050081,高雄市,三民區,豐裕里,332,236,315,657,17,-421,5.397,-64.079
64000050082,高雄市,三民區,川東里,182,118,195,333,-13,-215,-6.667,-64.565
64000050083,高雄市,三民區,裕民里,211,120,191,314,20,-194,10.471,-61.783
64000050084,高雄市,三民區,力行里,157,132,177,318,-20,-186,-11.299,-58.491
64000050085,高雄市,三民區,千歲里,216,140,223,355,-7,-215,-3.139,-60.563
64000050086,高雄市,三民區,立德里,209,158,218,339,-9,-181,-4.128,-53.392
64000050087,高雄市,三民區,千北里,161,117,153,306,8,-189,5.229,-61.765
64000050088,高雄市,三民區,千秋里,301,229,304,580,-3,-351,-0.987,-60.517
64000080001,高雄市,苓雅區,博仁里,117,66,162,178,-45,-112,-27.778,-62.921
64000080002,高雄市,苓雅區,苓洲里,269,144,287,336,-18,-192,-6.272,-57.143
64000080003,高雄市,苓雅區,苓昇里,179,121,213,293,-34,-172,-15.962,-58.703
64000080004,高雄市,苓雅區,苓中里,263,222,260,442,3,-220,1.154,-49.774
64000080005,高雄市,苓雅區,苓雅里,255,142,276,334,-21,-192,-7.609,-57.485
64000080006,高雄市,苓雅區,苓東里,226,164,210,393,16,-229,7.619,-58.27
64000080007,高雄市,苓雅區,城北里,335,168,276,381,59,-213,21.377,-55.906
64000080008,高雄市,苓雅區,城西里,96,70,96,162,0,-92,0.0,-56.79
64000080009,高雄市,苓雅區,城東里,327,198,325,473,2,-275,0.615,-58.14
64000080010,高雄市,苓雅區,意誠里,635,315,650,737,-15,-422,-2.308,-57.259
64000080011,高雄市,苓雅區,鼓中里,166,105,154,257,12,-152,7.792,-59.144
64000080012,高雄市,苓雅區,田西里,239,156,266,342,-27,-186,-10.15,-54.386
64000080013,高雄市,苓雅區,人和里,277,181,272,445,5,-264,1.838,-59.326
64000080014,高雄市,苓雅區,仁政里,247,154,287,348,-40,-194,-13.937,-55.747
64000080015,高雄市,苓雅區,廣澤里,253,202,281,536,-28,-334,-9.964,-62.313
64000080016,高雄市,苓雅區,美田里,168,103,209,284,-41,-181,-19.617,-63.732
64000080017,高雄市,苓雅區,華堂里,506,275,573,801,-67,-526,-11.693,-65.668
64000080018,高雄市,苓雅區,日中里,349,225,377,625,-28,-400,-7.427,-64.0
64000080019,高雄市,苓雅區,普照里,556,320,556,827,0,-507,0.0,-61.306
64000080020,高雄市,苓雅區,和煦里,316,171,379,519,-63,-348,-16.623,-67.052
64000080021,高雄市,苓雅區,晴朗里,340,153,321,433,19,-280,5.919,-64.665
64000080022,高雄市,苓雅區,普天里,619,394,675,890,-56,-496,-8.296,-55.73
64000080023,高雄市,苓雅區,林富里,467,216,444,585,23,-369,5.18,-63.077
64000080024,高雄市,苓雅區,林圍里,488,210,507,554,-19,-344,-3.748,-62.094
64000080025,高雄市,苓雅區,林安里,300,162,306,343,-6,-181,-1.961,-52.77
64000080026,高雄市,苓雅區,光華里,93,89,101,218,-8,-129,-7.921,-59.174
64000080027,高雄市,苓雅區,林興里,141,168,162,394,-21,-226,-12.963,-57.36
64000080028,高雄市,苓雅區,林華里,421,311,447,767,-26,-456,-5.817,-59.452
64000080029,高雄市,苓雅區,林西里,241,134,278,388,-37,-254,-13.309,-65.464
64000080030,高雄市,苓雅區,林中里,475,274,498,756,-23,-482,-4.618,-63.757
64000080031,高雄市,苓雅區,林泉里,401,133,418,455,-17,-322,-4.067,-70.769
64000080032,高雄市,苓雅區,林南里,532,207,656,652,-124,-445,-18.902,-68.252
64000080033,高雄市,苓雅區,中正里,525,271,548,718,-23,-447,-4.197,-62.256
64000080034,高雄市,苓雅區,尚義里,292,152,298,398,-6,-246,-2.013,-61.809
64000080035,高雄市,苓雅區,同慶里,411,201,469,517,-58,-316,-12.367,-61.122
64000080036,高雄市,苓雅區,凱旋里,417,161,491,449,-74,-288,-15.071,-64.143
64000080037,高雄市,苓雅區,安祥里,487,268,486,619,1,-351,0.206,-56.704
64000080038,高雄市,苓雅區,奏捷里,294,143,315,395,-21,-252,-6.667,-63.797
64000080039,高雄市,苓雅區,福壽里,205,184,206,473,-1,-289,-0.485,-61.099
64000080040,高雄市,苓雅區,福南里,290,175,286,501,4,-326,1.399,-65.07
64000080041,高雄市,苓雅區,五權里,520,322,492,599,28,-277,5.691,-46.244
64000080042,高雄市,苓雅區,民主里,768,461,718,1013,50,-552,6.964,-54.492
64000080043,高雄市,苓雅區,林德里,346,193,360,473,-14,-280,-3.889,-59.197
64000080044,高雄市,苓雅區,林貴里,320,180,326,450,-6,-270,-1.84,-60.0
64000080045,高雄市,苓雅區,林榮里,816,417,752,915,64,-498,8.511,-54.426
64000080046,高雄市,苓雅區,英明里,309,181,296,520,13,-339,4.392,-65.192
64000080047,高雄市,苓雅區,林靖里,406,120,400,334,6,-214,1.5,-64.072
64000080048,高雄市,苓雅區,朝陽里,235,162,229,390,6,-228,2.62,-58.462
64000080049,高雄市,苓雅區,福隆里,436,329,391,737,45,-408,11.509,-55.36
64000080050,高雄市,苓雅區,福祥里,236,146,233,294,3,-148,1.288,-50.34
64000080051,高雄市,苓雅區,福海里,170,85,220,230,-50,-145,-22.727,-63.043
64000080052,高雄市,苓雅區,福康里,291,197,278,572,13,-375,4.676,-65.559
64000080053,高雄市,苓雅區,福人里,352,185,342,476,10,-291,2.924,-61.134
64000080054,高雄市,苓雅區,福地里,456,242,413,654,43,-412,10.412,-62.997
64000080055,高雄市,苓雅區,福居里,346,249,349,708,-3,-459,-0.86,-64.831
64000080056,高雄市,苓雅區,福東里,478,254,455,643,23,-389,5.055,-60.498
64000080057,高雄市,苓雅區,福西里,284,165,276,507,8,-342,2.899,-67.456
64000080058,高雄市,苓雅區,永康里,407,228,441,544,-34,-316,-7.71,-58.088
64000080059,高雄市,苓雅區,正文里,416,239,396,597,20,-358,5.051,-59.966
64000080060,高雄市,苓雅區,正言里,490,283,510,691,-20,-408,-3.922,-59.045
64000080061,高雄市,苓雅區,正大里,917,427,931,1064,-14,-637,-1.504,-59.868
64000080062,高雄市,苓雅區,五福里,643,321,689,948,-46,-627,-6.676,-66.139
64000080063,高雄市,苓雅區,正心里,651,366,674,922,-23,-556,-3.412,-60.304
64000080064,高雄市,苓雅區,正道里,671,382,721,999,-50,-617,-6.935,-61.762
64000080065,高雄市,苓雅區,正義里,371,321,421,739,-50,-418,-11.876,-56.563
64000080066,高雄市,苓雅區,正仁里,411,195,442,564,-31,-369,-7.014,-65.426
64000080067,高雄市,苓雅區,文昌里,525,296,561,985,-36,-689,-6.417,-69.949
64000080068,高雄市,苓雅區,建軍里,296,188,272,524,24,-336,8.824,-64.122
64000080069,高雄市,苓雅區,衛武里,373,179,410,477,-37,-298,-9.024,-62.474
64000020001,高雄市,鼓山區,鼓峰里,466,142,462,382,4,-240,0.866,-62.827
64000020002,高雄市,鼓山區,雄峰里,511,114,529,292,-18,-178,-3.403,-60.959
64000020003,高雄市,鼓山區,前峰里,940,378,966,985,-26,-607,-2.692,-61.624
64000020004,高雄市,鼓山區,光榮里,532,407,454,1097,78,-690,17.181,-62.899
64000020005,高雄市,鼓山區,民族里,241,166,233,407,8,-241,3.433,-59.214
64000020006,高雄市,鼓山區,內惟里,163,133,148,333,15,-200,10.135,-60.06
64000020007,高雄市,鼓山區,建國里,440,280,425,660,15,-380,3.529,-57.576
64000020008,高雄市,鼓山區,忠正里,611,334,617,932,-6,-598,-0.972,-64.163
64000020009,高雄市,鼓山區,自強里,259,12,343,31,-84,-19,-24.49,-61.29
64000020010,高雄市,鼓山區,龍井里,208,137,196,323,12,-186,6.122,-57.585
64000020011,高雄市,鼓山區,正德里,281,202,264,596,17,-394,6.439,-66.107
64000020012,高雄市,鼓山區,平和里,558,413,533,1071,25,-658,4.69,-61.438
64000020013,高雄市,鼓山區,民強里,404,334,419,797,-15,-463,-3.58,-58.093
64000020014,高雄市,鼓山區,厚生里,449,327,457,902,-8,-575,-1.751,-63.747
64000020015,高雄市,鼓山區,龍子里,2951,1435,2888,3716,63,-2281,2.181,-61.383
64000020016,高雄市,鼓山區,龍水里,4820,2194,4466,5310,354,-3116,7.927,-58.682
64000020017,高雄市,鼓山區,明誠里,3286,1328,3365,3431,-79,-2103,-2.348,-61.294
64000020018,高雄市,鼓山區,華豐里,832,369,834,814,-2,-445,-0.24,-54.668
64000020019,高雄市,鼓山區,裕興里,726,305,740,685,-14,-380,-1.892,-55.474
64000020020,高雄市,鼓山區,裕豐里,641,156,675,466,-34,-310,-5.037,-66.524
64000020021,高雄市,鼓山區,鼓岩里,150,159,155,322,-5,-163,-3.226,-50.621
64000020022,高雄市,鼓山區,樹德里,171,163,170,395,1,-232,0.588,-58.734
64000020023,高雄市,鼓山區,寶樹里,138,146,183,337,-45,-191,-24.59,-56.677
64000020024,高雄市,鼓山區,興宗里,216,125,203,356,13,-231,6.404,-64.888
64000020025,高雄市,鼓山區,光化里,220,130,211,322,9,-192,4.265,-59.627
64000020026,高雄市,鼓山區,山下里,242,152,260,344,-18,-192,-6.923,-55.814
64000020027,高雄市,鼓山區,河邊里,192,121,220,336,-28,-215,-12.727,-63.988
64000020028,高雄市,鼓山區,綠川里,214,163,204,411,10,-248,4.902,-60.341
64000020029,高雄市,鼓山區,登山里,70,72,97,158,-27,-86,-27.835,-54.43
64000020030,高雄市,鼓山區,峰南里,111,109,99,254,12,-145,12.121,-57.087
64000020031,高雄市,鼓山區,麗興里,129,121,141,274,-12,-153,-8.511,-55.839
64000020032,高雄市,鼓山區,新民里,126,140,112,309,14,-169,12.5,-54.693
64000020033,高雄市,鼓山區,延平里,84,113,99,263,-15,-150,-15.152,-57.034
64000020034,高雄市,鼓山區,維生里,180,143,190,386,-10,-243,-5.263,-62.953
64000020035,高雄市,鼓山區,惠安里,159,126,136,337,23,-211,16.912,-62.611
64000020036,高雄市,鼓山區,壽山里,131,143,144,383,-13,-240,-9.028,-62.663
64000020037,高雄市,鼓山區,哨船頭里,160,104,179,249,-19,-145,-10.615,-58.233
64000020038,高雄市,鼓山區,桃源里,69,49,83,151,-14,-102,-16.867,-67.55
64000010001,高雄市,鹽埕區,藍橋里,217,167,197,431,20,-264,10.152,-61.253
64000010002,高雄市,鹽埕區,慈愛里,57,42,50,106,7,-64,14.0,-60.377
64000010003,高雄市,鹽埕區,博愛里,108,95,102,224,6,-129,5.882,-57.589
64000010004,高雄市,鹽埕區,壽星里,228,116,237,304,-9,-188,-3.797,-61.842
64000010005,高雄市,鹽埕區,中山里,194,192,244,349,-50,-157,-20.492,-44.986
64000010006,高雄市,鹽埕區,教仁里,342,213,357,572,-15,-359,-4.202,-62.762
64000010007,高雄市,鹽埕區,新樂里,152,89,171,244,-19,-155,-11.111,-63.525
64000010008,高雄市,鹽埕區,中原里,72,76,97,202,-25,-126,-25.773,-62.376
64000010009,高雄市,鹽埕區,光明里,202,138,189,393,13,-255,6.878,-64.885
64000010010,高雄市,鹽埕區,育仁里,99,84,128,232,-29,-148,-22.656,-63.793
64000010011,高雄市,鹽埕區,河濱里,265,185,298,484,-33,-299,-11.074,-61.777
64000010012,高雄市,鹽埕區,沙地里,93,76,97,235,-4,-159,-4.124,-67.66
64000010013,高雄市,鹽埕區,南端里,142,90,152,272,-10,-182,-6.579,-66.912
64000010014,高雄市,鹽埕區,港都里,159,135,163,336,-4,-201,-2.454,-59.821
64000010015,高雄市,鹽埕區,江西里,151,117,167,320,-16,-203,-9.581,-63.438
64000010016,高雄市,鹽埕區,新豐里,159,96,149,228,10,-132,6.711,-57.895
64000010017,高雄市,鹽埕區,府北里,324,245,322,542,2,-297,0.621,-54.797
64000010018,高雄市,鹽埕區,陸橋里,184,131,185,328,-1,-197,-0.541,-60.061
64000010019,高雄市,鹽埕區,瀨南里,82,84,92,186,-10,-102,-10.87,-54.839
64000010020,高雄市,鹽埕區,新化里,94,49,100,171,-6,-122,-6.0,-71.345
64000010021,高雄市,鹽埕區,江南里,54,84,48,214,6,-130,12.5,-60.748
64000070001,高雄市,前金區,三川里,141,103,81,245,60,-142,74.074,-57.959
64000070002,高雄市,前金區,草江里,276,107,222,265,54,-158,24.324,-59.623
64000070003,高雄市,前金區,長城里,221,192,191,388,30,-196,15.707,-50.515
64000070004,高雄市,前金區,北金里,111,84,134,239,-23,-155,-17.164,-64.854
64000070005,高雄市,前金區,東金里,157,131,174,298,-17,-167,-9.77,-56.04
64000070006,高雄市,前金區,新生里,727,342,740,886,-13,-544,-1.757,-61.4
64000070007,高雄市,前金區,後金里,113,57,129,181,-16,-124,-12.403,-68.508
64000070008,高雄市,前金區,長興里,233,132,217,314,16,-182,7.373,-57.962
64000070009,高雄市,前金區,青山里,347,197,329,484,18,-287,5.471,-59.298
64000070010,高雄市,前金區,民生里,155,97,159,192,-4,-95,-2.516,-49.479
64000070011,高雄市,前金區,復元里,208,135,198,278,10,-143,5.051,-51.439
64000070012,高雄市,前金區,林投里,127,103,133,271,-6,-168,-4.511,-61.993
64000070013,高雄市,前金區,國民里,179,95,159,251,20,-156,12.579,-62.151
64000070014,高雄市,前金區,社東里,270,140,306,373,-36,-233,-11.765,-62.466
64000070015,高雄市,前金區,社西里,268,121,237,271,31,-150,13.08,-55.351
64000070016,高雄市,前金區,博孝里,164,126,185,280,-21,-154,-11.351,-55.0
64000070017,高雄市,前金區,長生里,339,190,376,444,-37,-254,-9.84,-57.207
64000070018,高雄市,前金區,榮復里,184,118,199,288,-15,-170,-7.538,-59.028
64000070019,高雄市,前金區,文西里,186,130,161,288,25,-158,15.528,-54.861
64000070020,高雄市,前金區,文東里,211,128,223,318,-12,-190,-5.381,-59.748
64000060001,高雄市,新興區,浩然里,365,185,419,415,-54,-230,-12.888,-55.422
64000060002,高雄市,新興區,振成里,180,99,214,269,-34,-170,-15.888,-63.197
64000060003,高雄市,新興區,德生里,544,294,569,734,-25,-440,-4.394,-59.946
64000060004,高雄市,新興區,振華里,207,85,231,263,-24,-178,-10.39,-67.681
64000060005,高雄市,新興區,正氣里,269,142,268,379,1,-237,0.373,-62.533
64000060006,高雄市,新興區,德政里,157,57,152,151,5,-94,3.289,-62.252
64000060007,高雄市,新興區,仁聲里,173,114,176,244,-3,-130,-1.705,-53.279
64000060008,高雄市,新興區,德望里,333,176,347,482,-14,-306,-4.035,-63.485
64000060009,高雄市,新興區,華聲里,152,103,150,257,2,-154,1.333,-59.922
64000060010,高雄市,新興區,蕉園里,153,90,143,216,10,-126,6.993,-58.333
64000060011,高雄市,新興區,永寧里,242,162,230,368,12,-206,5.217,-55.978
64000060012,高雄市,新興區,玉衡里,148,75,117,197,31,-122,26.496,-61.929
64000060013,高雄市,新興區,順昌里,366,232,333,524,33,-292,9.91,-55.725
64000060014,高雄市,新興區,文昌里,556,299,553,772,3,-473,0.542,-61.269
64000060015,高雄市,新興區,光耀里,448,252,454,599,-6,-347,-1.322,-57.93
64000060016,高雄市,新興區,興昌里,294,158,351,432,-57,-274,-16.239,-63.426
64000060017,高雄市,新興區,開平里,596,356,670,905,-74,-549,-11.045,-60.663
64000060018,高雄市,新興區,成功里,308,154,284,301,24,-147,8.451,-48.837
64000060019,高雄市,新興區,新江里,140,93,156,300,-16,-207,-10.256,-69.0
64000060020,高雄市,新興區,黎明里,132,107,152,234,-20,-127,-13.158,-54.274
64000060021,高雄市,新興區,愛平里,176,120,166,271,10,-151,6.024,-55.72
64000060022,高雄市,新興區,南港里,344,287,330,656,14,-369,4.242,-56.25
64000060023,高雄市,新興區,中東里,456,222,474,600,-18,-378,-3.797,-63.0
64000060024,高雄市,新興區,明莊里,96,63,108,199,-12,-136,-11.111,-68.342
64000060025,高雄市,新興區,大明里,163,128,173,301,-10,-173,-5.78,-57.475
64000060026,高雄市,新興區,秋山里,138,104,153,264,-15,-160,-9.804,-60.606
64000060027,高雄市,新興區,長驛里,146,93,154,234,-8,-141,-5.195,-60.256
64000060028,高雄市,新興區,建興里,137,85,126,260,11,-175,8.73,-67.308
64000060029,高雄市,新興區,建華里,140,107,130,260,10,-153,7.692,-58.846
64000060030,高雄市,新興區,漢民里,114,92,119,207,-5,-115,-4.202,-55.556
64000060031,高雄市,新興區,榮治里,138,84,153,179,-15,-95,-9.804,-53.073
64000060032,高雄市,新興區,東坡里,167,163,174,399,-7,-236,-4.023,-59.148
64000120007,高雄市,鳳山區,鳳崗里,231,102,234,257,-3,-155,-1.282,-60.311
64000120010,高雄市,鳳山區,縣衙里,193,87,173,185,20,-98,11.561,-52.973
64000120041,高雄市,鳳山區,曹公里,379,187,411,464,-32,-277,-7.786,-59.698
64000120012,高雄市,鳳山區,鎮西里,924,502,899,1255,25,-753,2.781,-60.0
64000120053,高雄市,鳳山區,北門里,705,388,648,1017,57,-629,8.796,-61.849
64000120009,高雄市,鳳山區,鎮北里,1815,907,1448,2272,367,-1365,25.345,-60.079
64000120058,高雄市,鳳山區,武松里,425,241,414,634,11,-393,2.657,-61.987
64000120024,高雄市,鳳山區,忠誠里,689,378,559,935,130,-557,23.256,-59.572
64000120011,高雄市,鳳山區,文英里,627,331,623,892,4,-561,0.642,-62.892
64000120056,高雄市,鳳山區,文華里,1871,670,1860,1745,11,-1075,0.591,-61.605
64000120048,高雄市,鳳山區,文山里,1065,617,1013,1702,52,-1085,5.133,-63.749
64000120039,高雄市,鳳山區,文德里,1973,765,1816,1977,157,-1212,8.645,-61.305
64000120059,高雄市,鳳山區,文衡里,808,359,741,940,67,-581,9.042,-61.809
64000120060,高雄市,鳳山區,文福里,2010,870,1889,2181,121,-1311,6.406,-60.11
64000120002,高雄市,鳳山區,成功里,82,72,101,177,-19,-105,-18.812,-59.322
64000120001,高雄市,鳳山區,縣口里,60,47,73,100,-13,-53,-17.808,-53.0
64000120003,高雄市,鳳山區,光明里,238,143,222,351,16,-208,7.207,-59.259
64000120006,高雄市,鳳山區,和德里,574,239,440,523,134,-284,30.455,-54.302
64000120046,高雄市,鳳山區,和興里,874,484,854,1184,20,-700,2.342,-59.122
64000120005,高雄市,鳳山區,南興里,152,97,166,247,-14,-150,-8.434,-60.729
64000120051,高雄市,鳳山區,三民里,222,134,218,287,4,-153,1.835,-53.31
64000120021,高雄市,鳳山區,新興里,233,150,263,451,-30,-301,-11.407,-66.741
64000120042,高雄市,鳳山區,興仁里,673,312,644,875,29,-563,4.503,-64.343
64000120004,高雄市,鳳山區,興中里,220,89,212,217,8,-128,3.774,-58.986
64000120047,高雄市,鳳山區,協和里,746,282,781,685,-35,-403,-4.481,-58.832
64000120019,高雄市,鳳山區,忠義里,932,443,953,1090,-21,-647,-2.204,-59.358
64000120044,高雄市,鳳山區,忠孝里,1080,477,1144,1298,-64,-821,-5.594,-63.251
64000120008,高雄市,鳳山區,中和里,755,320,795,794,-40,-474,-5.031,-59.698
64000120020,高雄市,鳳山區,誠義里,974,334,852,833,122,-499,14.319,-59.904
64000120045,高雄市,鳳山區,生明里,519,165,493,396,26,-231,5.274,-58.333
64000120013,高雄市,鳳山區,鎮東里,453,186,383,572,70,-386,18.277,-67.483
64000120018,高雄市,鳳山區,瑞竹里,1022,445,980,1133,42,-688,4.286,-60.724
64000120031,高雄市,鳳山區,瑞興里,1012,473,1004,1013,8,-540,0.797,-53.307
64000120030,高雄市,鳳山區,東門里,1210,373,1226,998,-16,-625,-1.305,-62.625
64000120050,高雄市,鳳山區,誠德里,551,187,564,450,-13,-263,-2.305,-58.444
64000120061,高雄市,鳳山區,誠信里,477,100,526,286,-49,-186,-9.316,-65.035
64000120062,高雄市,鳳山區,誠智里,592,167,593,478,-1,-311,-0.169,-65.063
64000120035,高雄市,鳳山區,鳳東里,1424,659,1146,1531,278,-872,24.258,-56.956
64000120014,高雄市,鳳山區,埤頂里,1228,526,1192,1319,36,-793,3.02,-60.121
64000120015,高雄市,鳳山區,中正里,1318,168,1508,369,-190,-201,-12.599,-54.472
64000120022,高雄市,鳳山區,海光里,692,230,716,533,-24,-303,-3.352,-56.848
64000120034,高雄市,鳳山區,國泰里,674,371,686,907,-12,-536,-1.749,-59.096
64000120037,高雄市,鳳山區,國光里,597,290,654,822,-57,-532,-8.716,-64.72
64000120038,高雄市,鳳山區,國隆里,372,278,346,718,26,-440,7.514,-61.281
64000120063,高雄市,鳳山區,國富里,551,247,562,616,-11,-369,-1.957,-59.903
64000120064,高雄市,鳳山區,武慶里,378,266,390,619,-12,-353,-3.077,-57.027
64000120026,高雄市,鳳山區,武漢里,800,501,742,1261,58,-760,7.817,-60.27
64000120025,高雄市,鳳山區,新甲里,576,324,519,820,57,-496,10.983,-60.488
64000120066,高雄市,鳳山區,新武里,431,339,346,697,85,-358,24.566,-51.363
64000120068,高雄市,鳳山區,新泰里,748,336,718,924,30,-588,4.178,-63.636
64000120067,高雄市,鳳山區,新樂里,736,385,732,1085,4,-700,0.546,-64.516
64000120033,高雄市,鳳山區,新強里,985,568,911,1400,74,-832,8.123,-59.429
64000120065,高雄市,鳳山區,海洋里,712,398,674,997,38,-599,5.638,-60.08
64000120036,高雄市,鳳山區,新富里,634,384,593,1052,41,-668,6.914,-63.498
64000120017,高雄市,鳳山區,老爺里,1050,779,906,1891,144,-1112,15.894,-58.805
64000120071,高雄市,鳳山區,中民里,688,410,651,1179,37,-769,5.684,-65.225
64000120069,高雄市,鳳山區,中崙里,488,231,461,602,27,-371,5.857,-61.628
64000120070,高雄市,鳳山區,中榮里,816,356,741,1003,75,-647,10.121,-64.506
64000120040,高雄市,鳳山區,過埤里,2572,1143,2088,3026,484,-1883,23.18,-62.227
64000120027,高雄市,鳳山區,正義里,938,689,847,1761,91,-1072,10.744,-60.875
64000120078,高雄市,鳳山區,保安里,1185,626,997,1639,188,-1013,18.857,-61.806
64000120028,高雄市,鳳山區,一甲里,428,295,386,876,42,-581,10.881,-66.324
64000120072,高雄市,鳳山區,二甲里,797,530,677,1241,120,-711,17.725,-57.293
64000120073,高雄市,鳳山區,龍成里,426,318,363,770,63,-452,17.355,-58.701
64000120016,高雄市,鳳山區,鎮南里,754,495,727,1240,27,-745,3.714,-60.081
64000120054,高雄市,鳳山區,富甲里,286,202,254,474,32,-272,12.598,-57.384
64000120075,高雄市,鳳山區,善美里,863,489,745,1320,118,-831,15.839,-62.955
64000120074,高雄市,鳳山區,富榮里,396,229,376,608,20,-379,5.319,-62.336
64000120076,高雄市,鳳山區,南和里,370,259,334,768,36,-509,10.778,-66.276
64000120055,高雄市,鳳山區,南成里,1636,1074,1167,2346,469,-1272,40.189,-54.22
64000120032,高雄市,鳳山區,天興里,487,372,524,980,-37,-608,-7.061,-62.041
64000120057,高雄市,鳳山區,大德里,659,392,557,1148,102,-756,18.312,-65.854
64000120043,高雄市,鳳山區,五福里,497,274,459,864,38,-590,8.279,-68.287
64000120029,高雄市,鳳山區,福興里,739,578,751,1577,-12,-999,-1.598,-63.348
64000120077,高雄市,鳳山區,福祥里,344,272,322,774,22,-502,6.832,-64.858
64000120049,高雄市,鳳山區,福誠里,897,515,699,1265,198,-750,28.326,-59.289
64000100001,高雄市,旗津區,旗下里,143,145,131,379,12,-234,9.16,-61.741
64000100002,高雄市,旗津區,永安里,140,80,127,256,13,-176,10.236,-68.75
64000100003,高雄市,旗津區,振興里,162,167,172,449,-10,-282,-5.814,-62.806
64000100004,高雄市,旗津區,慈愛里,199,202,218,574,-19,-372,-8.716,-64.808
64000100005,高雄市,旗津區,復興里,399,198,392,598,7,-400,1.786,-66.89
64000100006,高雄市,旗津區,中華里,193,200,169,469,24,-269,14.201,-57.356
64000100007,高雄市,旗津區,實踐里,283,86,300,206,-17,-120,-5.667,-58.252
64000100008,高雄市,旗津區,北汕里,344,185,277,595,67,-410,24.188,-68.908
64000100009,高雄市,旗津區,南汕里,201,159,184,595,17,-436,9.239,-73.277
64000100010,高雄市,旗津區,上竹里,243,276,212,821,31,-545,14.623,-66.382
64000100011,高雄市,旗津區,中洲里,180,135,182,560,-2,-425,-1.099,-75.893
64000100012,高雄市,旗津區,安順里,82,84,62,268,20,-184,32.258,-68.657
64000100013,高雄市,旗津區,中興里,307,287,296,716,11,-429,3.716,-59.916
64000090001,高雄市,前鎮區,草衙里,1234,850,1104,2488,130,-1638,11.775,-65.836
64000090002,高雄市,前鎮區,明孝里,337,290,290,690,47,-400,16.207,-57.971
64000090003,高雄市,前鎮區,明正里,799,575,691,1526,108,-951,15.63,-62.32
64000090004,高雄市,前鎮區,明義里,421,284,335,643,86,-359,25.672,-55.832
64000090005,高雄市,前鎮區,仁愛里,192,124,161,404,31,-280,19.255,-69.307
64000090006,高雄市,前鎮區,德昌里,298,180,285,447,13,-267,4.561,-59.732
64000090007,高雄市,前鎮區,平等里,304,203,291,564,13,-361,4.467,-64.007
64000090008,高雄市,前鎮區,平昌里,97,53,58,183,39,-130,67.241,-71.038
64000090009,高雄市,前鎮區,明禮里,205,208,163,464,42,-256,25.767,-55.172
64000090010,高雄市,前鎮區,信義里,170,127,169,467,1,-340,0.592,-72.805
64000090011,高雄市,前鎮區,信德里,280,216,307,609,-27,-393,-8.795,-64.532
64000090012,高雄市,前鎮區,明道里,142,134,117,329,25,-195,21.368,-59.271
64000090013,高雄市,前鎮區,興化里,89,89,90,223,-1,-134,-1.111,-60.09
64000090014,高雄市,前鎮區,興仁里,68,94,70,241,-2,-147,-2.857,-60.996
64000090015,高雄市,前鎮區,前鎮里,154,177,169,424,-15,-247,-8.876,-58.255
64000090016,高雄市,前鎮區,鎮東里,261,260,233,597,28,-337,12.017,-56.449
64000090017,高雄市,前鎮區,鎮榮里,252,252,265,645,-13,-393,-4.906,-60.93
64000090018,高雄市,前鎮區,鎮昌里,257,230,255,601,2,-371,0.784,-61.73
64000090019,高雄市,前鎮區,鎮海里,653,525,638,1117,15,-592,2.351,-52.999
64000090020,高雄市,前鎮區,鎮陽里,158,72,147,253,11,-181,7.483,-71.542
64000090021,高雄市,前鎮區,興邦里,642,272,543,708,99,-436,18.232,-61.582
64000090022,高雄市,前鎮區,鎮中里,132,98,122,244,10,-146,8.197,-59.836
64000090023,高雄市,前鎮區,鎮北里,188,124,176,321,12,-197,6.818,-61.371
64000090024,高雄市,前鎮區,忠純里,1615,334,1736,782,-121,-448,-6.97,-57.289
64000090025,高雄市,前鎮區,忠誠里,710,64,798,183,-88,-119,-11.028,-65.027
64000090028,高雄市,前鎮區,西山里,625,346,675,789,-50,-443,-7.407,-56.147
64000090029,高雄市,前鎮區,民權里,944,407,963,967,-19,-560,-1.973,-57.911
64000090030,高雄市,前鎮區,建隆里,267,129,263,322,4,-193,1.521,-59.938
64000090031,高雄市,前鎮區,振興里,515,191,464,543,51,-352,10.991,-64.825
64000090032,高雄市,前鎮區,良和里,637,257,716,642,-79,-385,-11.034,-59.969
64000090033,高雄市,前鎮區,西甲里,340,242,330,579,10,-337,3.03,-58.204
64000090034,高雄市,前鎮區,盛興里,445,242,537,571,-92,-329,-17.132,-57.618
64000090035,高雄市,前鎮區,盛豐里,508,352,505,798,3,-446,0.594,-55.89
64000090036,高雄市,前鎮區,興中里,483,291,545,751,-62,-460,-11.376,-61.252
64000090037,高雄市,前鎮區,興東里,1062,509,1075,1411,-13,-902,-1.209,-63.926
64000090038,高雄市,前鎮區,忠孝里,706,336,651,720,55,-384,8.449,-53.333
64000090039,高雄市,前鎮區,復國里,378,263,428,748,-50,-485,-11.682,-64.84
64000090040,高雄市,前鎮區,竹內里,417,347,415,825,2,-478,0.482,-57.939
64000090041,高雄市,前鎮區,竹東里,342,205,351,574,-9,-369,-2.564,-64.286
64000090042,高雄市,前鎮區,竹南里,1304,665,1205,1685,99,-1020,8.216,-60.534
64000090043,高雄市,前鎮區,竹北里,422,252,397,601,25,-349,6.297,-58.07
64000090044,高雄市,前鎮區,竹西里,792,432,773,1059,19,-627,2.458,-59.207
64000090045,高雄市,前鎮區,竹中里,665,362,636,898,29,-536,4.56,-59.688
64000090046,高雄市,前鎮區,瑞竹里,353,228,222,422,131,-194,59.009,-45.972
64000090047,高雄市,前鎮區,瑞南里,696,432,658,1260,38,-828,5.775,-65.714
64000090048,高雄市,前鎮區,瑞豐里,396,243,385,701,11,-458,2.857,-65.335
64000090049,高雄市,前鎮區,瑞祥里,720,437,713,1179,7,-742,0.982,-62.935
64000090050,高雄市,前鎮區,瑞東里,293,258,284,659,9,-401,3.169,-60.85
64000090051,高雄市,前鎮區,瑞和里,256,201,237,551,19,-350,8.017,-63.521
64000090052,高雄市,前鎮區,瑞平里,596,435,563,1040,33,-605,5.861,-58.173
64000090053,高雄市,前鎮區,瑞隆里,530,354,511,983,19,-629,3.718,-63.988
64000090054,高雄市,前鎮區,瑞北里,502,379,420,936,82,-557,19.524,-59.509
64000090055,高雄市,前鎮區,瑞西里,358,338,291,772,67,-434,23.024,-56.218
64000090056,高雄市,前鎮區,瑞崗里,408,302,372,770,36,-468,9.677,-60.779
64000090057,高雄市,前鎮區,瑞興里,347,350,334,747,13,-397,3.892,-53.146
64000090058,高雄市,前鎮區,瑞誠里,418,249,400,668,18,-419,4.5,-62.725
64000090059,高雄市,前鎮區,瑞文里,343,277,296,691,47,-414,15.878,-59.913
64000090060,高雄市,前鎮區,瑞華里,741,463,756,1206,-15,-743,-1.984,-61.609
64000090061,高雄市,前鎮區,瑞昌里,456,353,403,913,53,-560,13.151,-61.336
64000110001,高雄市,小港區,小港里,326,206,344,636,-18,-430,-5.233,-67.61
64000110002,高雄市,小港區,港口里,622,322,610,765,12,-443,1.967,-57.908
64000110003,高雄市,小港區,港正里,498,210,461,537,37,-327,8.026,-60.894
64000110004,高雄市,小港區,港墘里,259,159,251,407,8,-248,3.187,-60.934
64000110005,高雄市,小港區,港明里,404,249,388,734,16,-485,4.124,-66.076
64000110006,高雄市,小港區,港后里,425,301,393,698,32,-397,8.142,-56.877
64000110007,高雄市,小港區,港南里,498,251,326,576,172,-325,52.761,-56.424
64000110008,高雄市,小港區,港興里,403,238,364,646,39,-408,10.714,-63.158
64000110009,高雄市,小港區,鳳宮里,389,230,334,662,55,-432,16.467,-65.257
64000110010,高雄市,小港區,店鎮里,871,530,783,1466,88,-936,11.239,-63.847
64000110011,高雄市,小港區,大苓里,410,296,384,664,26,-368,6.771,-55.422
64000110012,高雄市,小港區,二苓里,473,366,442,976,31,-610,7.014,-62.5
64000110013,高雄市,小港區,三苓里,423,257,429,756,-6,-499,-1.399,-66.005
64000110014,高雄市,小港區,正苓里,656,276,617,854,39,-578,6.321,-67.681
64000110015,高雄市,小港區,順苓里,715,355,658,1063,57,-708,8.663,-66.604
64000110016,高雄市,小港區,六苓里,414,274,390,692,24,-418,6.154,-60.405
64000110017,高雄市,小港區,宏亮里,438,273,462,748,-24,-475,-5.195,-63.503
64000110018,高雄市,小港區,山東里,543,217,532,614,11,-397,2.068,-64.658
64000110019,高雄市,小港區,青島里,596,183,598,411,-2,-228,-0.334,-55.474
64000110020,高雄市,小港區,濟南里,803,343,777,883,26,-540,3.346,-61.155
64000110021,高雄市,小港區,泰山里,502,300,490,843,12,-543,2.449,-64.413
64000110022,高雄市,小港區,山明里,1813,1054,1450,2774,363,-1720,25.034,-62.004
64000110023,高雄市,小港區,高松里,656,402,562,1034,94,-632,16.726,-61.122
64000110024,高雄市,小港區,松金里,350,262,334,668,16,-406,4.79,-60.778
64000110025,高雄市,小港區,松山里,544,283,506,822,38,-539,7.51,-65.572
64000110026,高雄市,小港區,大坪里,455,245,362,756,93,-511,25.691,-67.593
64000110027,高雄市,小港區,坪頂里,927,552,751,1432,176,-880,23.435,-61.453
64000110028,高雄市,小港區,孔宅里,789,446,724,1203,65,-757,8.978,-62.926
64000110029,高雄市,小港區,廈莊里,698,402,571,906,127,-504,22.242,-55.629
64000110030,高雄市,小港區,合作里,434,311,375,772,59,-461,15.733,-59.715
64000110031,高雄市,小港區,桂林里,1255,801,1060,2019,195,-1218,18.396,-60.327
64000110032,高雄市,小港區,中厝里,529,328,468,892,61,-564,13.034,-63.229
64000110033,高雄市,小港區,鳳鳴里,448,274,421,794,27,-520,6.413,-65.491
64000110034,高雄市,小港區,龍鳳里,381,268,392,801,-11,-533,-2.806,-66.542
64000110035,高雄市,小港區,鳳森里,246,213,239,658,7,-445,2.929,-67.629
64000110036,高雄市,小港區,鳳林里,292,322,327,878,-35,-556,-10.703,-63.326
64000110037,高雄市,小港區,鳳興里,284,225,267,658,17,-433,6.367,-65.805
64000110038,高雄市,小港區,鳳源里,339,321,313,1029,26,-708,8.307,-68.805
65000220001,新北市,石門區,德茂里,136,51,144,192,-8,-141,-5.556,-73.438
65000220002,新北市,石門區,富基里,219,47,245,236,-26,-189,-10.612,-80.085
65000220003,新北市,石門區,老梅里,252,99,289,335,-37,-236,-12.803,-70.448
65000220004,新北市,石門區,山溪里,139,45,131,137,8,-92,6.107,-67.153
65000220005,新北市,石門區,石門里,250,45,271,246,-21,-201,-7.749,-81.707
65000220006,新北市,石門區,尖鹿里,215,41,213,214,2,-173,0.939,-80.841
65000220007,新北市,石門區,乾華里,50,9,49,51,1,-42,2.041,-82.353
65000220008,新北市,石門區,茂林里,97,22,90,102,7,-80,7.778,-78.431
65000220009,新北市,石門區,草里里,147,25,136,121,11,-96,8.088,-79.339
65000210001,新北市,三芝區,八賢里,48,25,29,76,19,-51,65.517,-67.105
65000210002,新北市,三芝區,埔頭里,856,229,780,779,76,-550,9.744,-70.603
65000210003,新北市,三芝區,古庄里,193,70,187,194,6,-124,3.209,-63.918
65000210004,新北市,三芝區,新庄里,146,38,137,139,9,-101,6.569,-72.662
65000210005,新北市,三芝區,埔坪里,1176,273,998,892,178,-619,17.836,-69.395
65000210006,新北市,三芝區,茂長里,158,38,138,138,20,-100,14.493,-72.464
65000210007,新北市,三芝區,橫山里,85,23,94,67,-9,-44,-9.574,-65.672
65000210008,新北市,三芝區,錫板里,134,36,121,160,13,-124,10.744,-77.5
65000210009,新北市,三芝區,後厝里,457,114,436,339,21,-225,4.817,-66.372
65000210010,新北市,三芝區,福德里,175,55,139,161,36,-106,25.899,-65.839
65000210011,新北市,三芝區,圓山里,79,13,61,95,18,-82,29.508,-86.316
65000210012,新北市,三芝區,店子里,84,32,69,123,15,-91,21.739,-73.984
65000210013,新北市,三芝區,興華里,188,72,163,271,25,-199,15.337,-73.432
65000100001,新北市,淡水區,中和里,86,38,68,126,18,-88,26.471,-69.841
65000100002,新北市,淡水區,屯山里,134,57,117,206,17,-149,14.53,-72.33
65000100003,新北市,淡水區,賢孝里,255,69,231,244,24,-175,10.39,-71.721
65000100004,新北市,淡水區,興仁里,235,91,245,321,-10,-230,-4.082,-71.651
65000100005,新北市,淡水區,蕃薯里,187,45,169,172,18,-127,10.651,-73.837
65000100007,新北市,淡水區,忠山里,147,51,149,174,-2,-123,-1.342,-70.69
65000100006,新北市,淡水區,義山里,403,104,376,428,27,-324,7.181,-75.701
65000100013,新北市,淡水區,水源里,290,122,259,484,31,-362,11.969,-74.793
65000100014,新北市,淡水區,忠寮里,180,62,145,256,35,-194,24.138,-75.781
65000100015,新北市,淡水區,樹興里,320,82,255,293,65,-211,25.49,-72.014
65000100016,新北市,淡水區,坪頂里,257,106,262,281,-5,-175,-1.908,-62.278
65000100017,新北市,淡水區,福德里,1721,450,1680,1406,41,-956,2.44,-67.994
65000100018,新北市,淡水區,竹圍里,1447,399,1346,1221,101,-822,7.504,-67.322
65000100039,新北市,淡水區,民權里,1113,343,906,1020,207,-677,22.848,-66.373
65000100019,新北市,淡水區,民生里,1583,508,1355,1406,228,-898,16.827,-63.869
65000100020,新北市,淡水區,八勢里,1499,473,1351,1210,148,-737,10.955,-60.909
65000100021,新北市,淡水區,竿蓁里,2606,730,2211,1853,395,-1123,17.865,-60.604
65000100008,新北市,淡水區,崁頂里,5459,1357,3407,2692,2052,-1335,60.229,-49.591
65000100009,新北市,淡水區,埤島里,348,95,261,318,87,-223,33.333,-70.126
65000100011,新北市,淡水區,水碓里,988,345,916,1063,72,-718,7.86,-67.545
65000100038,新北市,淡水區,北新里,585,136,491,471,94,-335,19.145,-71.125
65000100037,新北市,淡水區,正德里,974,231,892,752,82,-521,9.193,-69.282
65000100010,新北市,淡水區,新興里,1415,329,1348,1172,67,-843,4.97,-71.928
65000100034,新北市,淡水區,新義里,663,210,566,784,97,-574,17.138,-73.214
65000100035,新北市,淡水區,新春里,1731,454,1449,1488,282,-1034,19.462,-69.489
65000100036,新北市,淡水區,新民里,909,266,882,877,27,-611,3.061,-69.669
65000100012,新北市,淡水區,北投里,2172,553,1936,1721,236,-1168,12.19,-67.868
65000100022,新北市,淡水區,鄧公里,1192,321,1177,1113,15,-792,1.274,-71.159
65000100040,新北市,淡水區,幸福里,684,203,655,755,29,-552,4.427,-73.113
65000100041,新北市,淡水區,學府里,884,225,832,742,52,-517,6.25,-69.677
65000100023,新北市,淡水區,中興里,756,187,660,735,96,-548,14.545,-74.558
65000100024,新北市,淡水區,長庚里,279,88,269,339,10,-251,3.717,-74.041
65000100025,新北市,淡水區,清文里,188,69,169,253,19,-184,11.243,-72.727
65000100026,新北市,淡水區,草東里,137,55,123,182,14,-127,11.382,-69.78
65000100027,新北市,淡水區,協元里,240,83,225,294,15,-211,6.667,-71.769
65000100028,新北市,淡水區,永吉里,178,79,173,224,5,-145,2.89,-64.732
65000100029,新北市,淡水區,民安里,112,51,130,185,-18,-134,-13.846,-72.432
65000100030,新北市,淡水區,新生里,91,40,81,103,10,-63,12.346,-61.165
65000100031,新北市,淡水區,文化里,378,107,353,313,25,-206,7.082,-65.815
65000100032,新北市,淡水區,油車里,1129,301,1094,948,35,-647,3.199,-68.249
65000100033,新北市,淡水區,沙崙里,977,250,842,748,135,-498,16.033,-66.578
65000100042,新北市,淡水區,大庄里,2975,730,2121,1688,854,-958,40.264,-56.754
65000230001,新北市,八里區,龍源里,1541,477,1328,1450,213,-973,16.039,-67.103
65000230002,新北市,八里區,米倉里,684,185,561,634,123,-449,21.925,-70.82
65000230003,新北市,八里區,大崁里,640,206,518,686,122,-480,23.552,-69.971
65000230004,新北市,八里區,埤頭里,804,252,606,813,198,-561,32.673,-69.004
65000230005,新北市,八里區,頂罟里,399,127,355,425,44,-298,12.394,-70.118
65000230006,新北市,八里區,舊城里,1146,387,993,1331,153,-944,15.408,-70.924
65000230007,新北市,八里區,訊塘里,996,282,655,806,341,-524,52.061,-65.012
65000230008,新北市,八里區,荖阡里,271,85,244,319,27,-234,11.066,-73.354
65000230009,新北市,八里區,長坑里,262,69,213,294,49,-225,23.005,-76.531
65000230010,新北市,八里區,下罟里,266,60,229,264,37,-204,16.157,-77.273
65000170001,新北市,林口區,東林里,502,192,492,725,10,-533,2.033,-73.517
65000170002,新北市,林口區,林口里,869,262,827,904,42,-642,5.079,-71.018
65000170003,新北市,林口區,西林里,2058,568,1771,1972,287,-1404,16.206,-71.197
65000170004,新北市,林口區,菁湖里,693,278,683,964,10,-686,1.464,-71.162
65000170005,新北市,林口區,中湖里,812,227,681,872,131,-645,19.236,-73.968
65000170006,新北市,林口區,湖北里,255,123,222,387,33,-264,14.865,-68.217
65000170007,新北市,林口區,湖南里,5195,1235,4587,3775,608,-2540,13.255,-67.285
65000170008,新北市,林口區,南勢里,5705,1401,4598,4052,1107,-2651,24.076,-65.424
65000170015,新北市,林口區,仁愛里,1381,324,1393,1122,-12,-798,-0.861,-71.123
65000170016,新北市,林口區,麗林里,1947,443,1753,1394,194,-951,11.067,-68.221
65000170009,新北市,林口區,東勢里,1479,393,1452,1277,27,-884,1.86,-69.225
65000170017,新北市,林口區,麗園里,801,188,772,779,29,-591,3.756,-75.866
65000170010,新北市,林口區,頂福里,94,43,92,265,2,-222,2.174,-83.774
65000170011,新北市,林口區,下福里,189,70,178,273,11,-203,6.18,-74.359
65000170012,新北市,林口區,嘉寶里,141,60,138,259,3,-199,2.174,-76.834
65000170013,新北市,林口區,瑞平里,74,27,90,172,-16,-145,-17.778,-84.302
65000170014,新北市,林口區,太平里,155,78,139,320,16,-242,11.511,-75.625
65000160001,新北市,泰山區,大科里,146,61,124,201,22,-140,17.742,-69.652
65000160002,新北市,泰山區,黎明里,660,193,551,672,109,-479,19.782,-71.28
65000160003,新北市,泰山區,山腳里,1121,331,1024,1219,97,-888,9.473,-72.847
65000160004,新北市,泰山區,福泰里,453,174,428,557,25,-383,5.841,-68.761
65000160016,新北市,泰山區,福興里,657,156,605,650,52,-494,8.595,-76.0
65000160005,新北市,泰山區,楓樹里,770,238,698,844,72,-606,10.315,-71.801
65000160006,新北市,泰山區,同榮里,787,273,731,774,56,-501,7.661,-64.729
65000160011,新北市,泰山區,同興里,662,214,560,814,102,-600,18.214,-73.71
65000160017,新北市,泰山區,全興里,1378,421,1355,1568,23,-1147,1.697,-73.151
65000160007,新北市,泰山區,義學里,795,254,738,934,57,-680,7.724,-72.805
65000160012,新北市,泰山區,義仁里,1845,592,1277,1615,568,-1023,44.479,-63.344
65000160008,新北市,泰山區,明志里,709,254,653,794,56,-540,8.576,-68.01
65000160013,新北市,泰山區,泰友里,390,137,353,414,37,-277,10.482,-66.908
65000160014,新北市,泰山區,新明里,564,191,498,648,66,-457,13.253,-70.525
65000160009,新北市,泰山區,貴子里,816,271,754,818,62,-547,8.223,-66.87
65000160015,新北市,泰山區,貴賢里,824,266,733,801,91,-535,12.415,-66.792
65000160010,新北市,泰山區,貴和里,871,280,814,1006,57,-726,7.002,-72.167
65000150001,新北市,五股區,興珍里,727,375,548,1188,179,-813,32.664,-68.434
65000150002,新北市,五股區,更寮里,134,121,119,370,15,-249,12.605,-67.297
65000150004,新北市,五股區,觀音里,168,85,139,355,29,-270,20.863,-76.056
65000150003,新北市,五股區,集福里,748,322,573,915,175,-593,30.541,-64.809
65000150016,新北市,五股區,集賢里,666,284,529,961,137,-677,25.898,-70.447
65000150014,新北市,五股區,成德里,473,216,435,679,38,-463,8.736,-68.189
65000150005,新北市,五股區,成州里,920,374,730,1235,190,-861,26.027,-69.717
65000150006,新北市,五股區,成功里,1342,515,896,1510,446,-995,49.777,-65.894
65000150018,新北市,五股區,成泰里,2237,702,1480,2052,757,-1350,51.149,-65.789
65000150007,新北市,五股區,五龍里,152,131,129,395,23,-264,17.829,-66.835
65000150009,新北市,五股區,五福里,570,262,509,731,61,-469,11.984,-64.159
65000150015,新北市,五股區,六福里,705,203,639,718,66,-515,10.329,-71.727
65000150017,新北市,五股區,民義里,635,235,568,736,67,-501,11.796,-68.071
65000150008,新北市,五股區,五股里,574,249,573,815,1,-566,0.175,-69.448
65000150010,新北市,五股區,德音里,1032,344,904,1041,128,-697,14.159,-66.955
65000150020,新北市,五股區,福德里,537,165,432,591,105,-426,24.306,-72.081
65000150019,新北市,五股區,水碓里,1169,458,1075,1663,94,-1205,8.744,-72.459
65000150013,新北市,五股區,德泰里,753,228,728,826,25,-598,3.434,-72.397
65000150012,新北市,五股區,貿商里,897,134,864,379,33,-245,3.819,-64.644
65000150011,新北市,五股區,陸一里,810,79,830,220,-20,-141,-2.41,-64.091
65000140004,新北市,蘆洲區,光華里,774,380,715,1201,59,-821,8.252,-68.36
65000140029,新北市,蘆洲區,光明里,623,328,633,1072,-10,-744,-1.58,-69.403
65000140003,新北市,蘆洲區,中路里,677,333,565,885,112,-552,19.823,-62.373
65000140035,新北市,蘆洲區,永安里,826,377,652,1177,174,-800,26.687,-67.969
65000140024,新北市,蘆洲區,九芎里,797,351,744,1113,53,-762,7.124,-68.464
65000140036,新北市,蘆洲區,延平里,662,325,550,922,112,-597,20.364,-64.751
65000140025,新北市,蘆洲區,中華里,481,250,458,801,23,-551,5.022,-68.789
65000140002,新北市,蘆洲區,中原里,883,393,833,1214,50,-821,6.002,-67.628
65000140031,新北市,蘆洲區,長安里,593,311,542,1078,51,-767,9.41,-71.15
65000140023,新北市,蘆洲區,忠義里,556,208,377,641,179,-433,47.48,-67.551
65000140001,新北市,蘆洲區,正義里,2327,877,2022,2792,305,-1915,15.084,-68.589
65000140015,新北市,蘆洲區,南港里,781,349,709,1207,72,-858,10.155,-71.085
65000140016,新北市,蘆洲區,永樂里,1007,425,852,1290,155,-865,18.192,-67.054
65000140037,新北市,蘆洲區,成功里,1011,500,967,1620,44,-1120,4.55,-69.136
65000140017,新北市,蘆洲區,永康里,948,431,841,1412,107,-981,12.723,-69.476
65000140038,新北市,蘆洲區,永德里,598,260,528,881,70,-621,13.258,-70.488
65000140007,新北市,蘆洲區,樓厝里,1161,472,1044,1416,117,-944,11.207,-66.667
65000140018,新北市,蘆洲區,信義里,567,237,501,897,66,-660,13.174,-73.579
65000140019,新北市,蘆洲區,玉清里,1015,432,932,1271,83,-839,8.906,-66.011
65000140020,新北市,蘆洲區,復興里,504,275,455,898,49,-623,10.769,-69.376
65000140034,新北市,蘆洲區,福安里,509,219,460,749,49,-530,10.652,-70.761
65000140008,新北市,蘆洲區,鷺江里,914,369,754,1184,160,-815,21.22,-68.834
65000140009,新北市,蘆洲區,恆德里,1093,406,968,1267,125,-861,12.913,-67.956
65000140010,新北市,蘆洲區,溪墘里,507,303,442,791,65,-488,14.706,-61.694
65000140013,新北市,蘆洲區,仁復里,314,142,283,451,31,-309,10.954,-68.514
65000140027,新北市,蘆洲區,仁德里,822,394,720,1242,102,-848,14.167,-68.277
65000140028,新北市,蘆洲區,仁義里,668,318,628,961,40,-643,6.369,-66.909
65000140014,新北市,蘆洲區,得勝里,518,261,458,722,60,-461,13.1,-63.85
65000140026,新北市,蘆洲區,得仁里,499,261,466,768,33,-507,7.082,-66.016
65000140012,新北市,蘆洲區,保和里,420,191,374,568,46,-377,12.299,-66.373
65000140011,新北市,蘆洲區,樹德里,500,280,502,794,-2,-514,-0.398,-64.736
65000140032,新北市,蘆洲區,民和里,437,188,403,606,34,-418,8.437,-68.977
65000140021,新北市,蘆洲區,水河里,1483,653,1190,2031,293,-1378,24.622,-67.848
65000140006,新北市,蘆洲區,水湳里,1624,735,1437,2211,187,-1476,13.013,-66.757
65000140022,新北市,蘆洲區,仁愛里,852,348,702,1181,150,-833,21.368,-70.533
65000140033,新北市,蘆洲區,忠孝里,310,156,287,591,23,-435,8.014,-73.604
65000140005,新北市,蘆洲區,保佑里,530,274,531,747,-1,-473,-0.188,-63.32
65000140030,新北市,蘆洲區,保新里,582,241,514,812,68,-571,13.23,-70.32
65000020105,新北市,三重區,富貴里,1214,382,1094,1375,120,-993,10.969,-72.218
65000020108,新北市,三重區,碧華里,1548,501,1418,1694,130,-1193,9.168,-70.425
65000020118,新北市,三重區,仁華里,810,320,677,1006,133,-686,19.645,-68.191
65000020090,新北市,三重區,永清里,758,430,639,1260,119,-830,18.623,-65.873
65000020114,新北市,三重區,永順里,670,314,570,1095,100,-781,17.544,-71.324
65000020107,新北市,三重區,富福里,269,136,251,432,18,-296,7.171,-68.519
65000020102,新北市,三重區,慈化里,404,136,351,578,53,-442,15.1,-76.471
65000020100,新北市,三重區,慈惠里,329,252,299,612,30,-360,10.033,-58.824
65000020101,新北市,三重區,慈愛里,559,322,497,890,62,-568,12.475,-63.82
65000020089,新北市,三重區,永福里,808,470,763,1283,45,-813,5.898,-63.367
65000020099,新北市,三重區,慈生里,384,203,369,565,15,-362,4.065,-64.071
65000020098,新北市,三重區,慈福里,376,187,286,573,90,-386,31.469,-67.365
65000020103,新北市,三重區,慈祐里,812,387,701,1134,111,-747,15.835,-65.873
65000020106,新北市,三重區,富華里,567,206,460,683,107,-477,23.261,-69.839
65000020104,新北市,三重區,五華里,858,430,738,1188,120,-758,16.26,-63.805
65000020096,新北市,三重區,五福里,572,224,533,817,39,-593,7.317,-72.583
65000020001,新北市,三重區,大有里,898,383,788,1251,110,-868,13.959,-69.384
65000020110,新北市,三重區,博愛里,787,336,742,1053,45,-717,6.065,-68.091
65000020002,新北市,三重區,二重里,365,168,212,353,153,-185,72.17,-52.408
65000020003,新北市,三重區,頂崁里,421,192,332,636,89,-444,26.807,-69.811
65000020004,新北市,三重區,谷王里,427,163,166,278,261,-115,157.229,-41.367
65000020109,新北市,三重區,五谷里,386,173,322,496,64,-323,19.876,-65.121
65000020005,新北市,三重區,中興里,736,369,613,1038,123,-669,20.065,-64.451
65000020006,新北市,三重區,德厚里,235,88,58,119,177,-31,305.172,-26.05
65000020007,新北市,三重區,成功里,1498,589,1189,1426,309,-837,25.988,-58.696
65000020008,新北市,三重區,福祉里,1020,413,900,1270,120,-857,13.333,-67.48
65000020111,新北市,三重區,福德里,741,316,680,887,61,-571,8.971,-64.374
65000020009,新北市,三重區,福民里,518,233,553,792,-35,-559,-6.329,-70.581
65000020010,新北市,三重區,過田里,1128,426,1139,1359,-11,-933,-0.966,-68.653
65000020011,新北市,三重區,錦田里,356,181,343,486,13,-305,3.79,-62.757
65000020012,新北市,三重區,重明里,708,304,626,872,82,-568,13.099,-65.138
65000020013,新北市,三重區,光田里,836,381,782,1108,54,-727,6.905,-65.614
65000020014,新北市,三重區,光陽里,1217,528,1163,1563,54,-1035,4.643,-66.219
65000020015,新北市,三重區,田心里,701,288,594,948,107,-660,18.013,-69.62
65000020016,新北市,三重區,福田里,655,325,592,875,63,-550,10.642,-62.857
65000020017,新北市,三重區,田中里,924,529,856,1562,68,-1033,7.944,-66.133
65000020018,新北市,三重區,田安里,1105,483,974,1440,131,-957,13.45,-66.458
65000020019,新北市,三重區,三民里,504,266,459,725,45,-459,9.804,-63.31
65000020020,新北市,三重區,光明里,1256,505,1232,1562,24,-1057,1.948,-67.67
65000020021,新北市,三重區,光正里,545,196,529,559,16,-363,3.025,-64.937
65000020022,新北市,三重區,同安里,313,119,215,276,98,-157,45.581,-56.884
65000020023,新北市,三重區,同慶里,364,121,311,384,53,-263,17.042,-68.49
65000020024,新北市,三重區,菜寮里,396,180,376,522,20,-342,5.319,-65.517
65000020025,新北市,三重區,永春里,374,125,330,405,44,-280,13.333,-69.136
65000020026,新北市,三重區,中正里,286,133,263,333,23,-200,8.745,-60.06
65000020027,新北市,三重區,吉利里,262,128,231,304,31,-176,13.42,-57.895
65000020028,新北市,三重區,大同里,403,180,321,446,82,-266,25.545,-59.641
65000020029,新北市,三重區,中民里,250,100,227,279,23,-179,10.132,-64.158
65000020030,新北市,三重區,平和里,292,128,268,340,24,-212,8.955,-62.353
65000020031,新北市,三重區,大安里,356,95,297,339,59,-244,19.865,-71.976
65000020032,新北市,三重區,仁德里,309,154,296,423,13,-269,4.392,-63.593
65000020033,新北市,三重區,忠孝里,318,133,304,407,14,-274,4.605,-67.322
65000020034,新北市,三重區,仁義里,246,131,213,298,33,-167,15.493,-56.04
65000020035,新北市,三重區,光榮里,271,110,230,308,41,-198,17.826,-64.286
65000020036,新北市,三重區,光輝里,288,127,261,350,27,-223,10.345,-63.714
65000020037,新北市,三重區,福星里,254,95,239,317,15,-222,6.276,-70.032
65000020038,新北市,三重區,福利里,461,173,423,502,38,-329,8.983,-65.538
65000020039,新北市,三重區,清和里,784,308,744,947,40,-639,5.376,-67.476
65000020040,新北市,三重區,永興里,311,136,266,343,45,-207,16.917,-60.35
65000020041,新北市,三重區,中山里,489,214,454,631,35,-417,7.709,-66.086
65000020042,新北市,三重區,大園里,422,216,383,622,39,-406,10.183,-65.273
65000020043,新北市,三重區,國隆里,710,257,540,597,170,-340,31.481,-56.951
65000020044,新北市,三重區,重陽里,557,252,552,767,5,-515,0.906,-67.145
65000020045,新北市,三重區,民生里,709,381,590,1058,119,-677,20.169,-63.989
65000020046,新北市,三重區,重新里,260,184,204,438,56,-254,27.451,-57.991
65000020047,新北市,三重區,正德里,201,96,195,271,6,-175,3.077,-64.576
65000020048,新北市,三重區,正義里,316,166,314,460,2,-294,0.637,-63.913
65000020049,新北市,三重區,正安里,365,155,356,445,9,-290,2.528,-65.169
65000020050,新北市,三重區,自強里,294,160,254,441,40,-281,15.748,-63.719
65000020051,新北市,三重區,文化里,376,198,397,558,-21,-360,-5.29,-64.516
65000020052,新北市,三重區,中央里,292,151,253,431,39,-280,15.415,-64.965
65000020053,新北市,三重區,雙園里,167,67,193,203,-26,-136,-13.472,-66.995
65000020054,新北市,三重區,錦通里,292,124,268,360,24,-236,8.955,-65.556
65000020055,新北市,三重區,錦安里,312,149,284,395,28,-246,9.859,-62.278
65000020056,新北市,三重區,長安里,355,181,317,501,38,-320,11.987,-63.872
65000020057,新北市,三重區,光華里,363,190,364,522,-1,-332,-0.275,-63.602
65000020058,新北市,三重區,長生里,113,78,130,215,-17,-137,-13.077,-63.721
65000020059,新北市,三重區,開元里,338,174,274,382,64,-208,23.358,-54.45
65000020060,新北市,三重區,大德里,161,52,150,204,11,-152,7.333,-74.51
65000020061,新北市,三重區,長元里,413,198,405,536,8,-338,1.975,-63.06
65000020062,新北市,三重區,長江里,354,169,330,486,24,-317,7.273,-65.226
65000020063,新北市,三重區,長泰里,360,147,338,507,22,-360,6.509,-71.006
65000020064,新北市,三重區,長福里,288,124,234,355,54,-231,23.077,-65.07
65000020065,新北市,三重區,介壽里,217,97,208,256,9,-159,4.327,-62.109
65000020066,新北市,三重區,萬壽里,372,139,345,472,27,-333,7.826,-70.551
65000020067,新北市,三重區,錦江里,336,150,291,514,45,-364,15.464,-70.817
65000020068,新北市,三重區,龍濱里,628,262,510,755,118,-493,23.137,-65.298
65000020069,新北市,三重區,龍門里,319,107,293,390,26,-283,8.874,-72.564
65000020070,新北市,三重區,秀江里,228,91,179,289,49,-198,27.374,-68.512
65000020071,新北市,三重區,奕壽里,259,180,278,443,-19,-263,-6.835,-59.368
65000020072,新北市,三重區,三安里,433,222,400,604,33,-382,8.25,-63.245
65000020073,新北市,三重區,福安里,629,257,454,726,175,-469,38.546,-64.601
65000020074,新北市,三重區,信安里,322,136,314,406,8,-270,2.548,-66.502
65000020075,新北市,三重區,安慶里,355,158,293,520,62,-362,21.16,-69.615
65000020076,新北市,三重區,幸福里,700,343,692,1090,8,-747,1.156,-68.532
65000020077,新北市,三重區,六合里,633,341,565,887,68,-546,12.035,-61.556
65000020078,新北市,三重區,六福里,875,397,750,1286,125,-889,16.667,-69.129
65000020079,新北市,三重區,順德里,405,169,342,540,63,-371,18.421,-68.704
65000020080,新北市,三重區,承德里,324,158,270,446,54,-288,20.0,-64.574
65000020081,新北市,三重區,瑞德里,406,192,378,554,28,-362,7.407,-65.343
65000020082,新北市,三重區,崇德里,646,359,572,971,74,-612,12.937,-63.028
65000020083,新北市,三重區,厚德里,626,304,597,871,29,-567,4.858,-65.098
65000020084,新北市,三重區,維德里,455,269,441,726,14,-457,3.175,-62.948
65000020085,新北市,三重區,尚德里,481,224,461,665,20,-441,4.338,-66.316
65000020086,新北市,三重區,培德里,571,299,559,940,12,-641,2.147,-68.191
65000020116,新北市,三重區,立德里,571,281,523,816,48,-535,9.178,-65.564
65000020087,新北市,三重區,永德里,724,379,674,1131,50,-752,7.418,-66.49
65000020092,新北市,三重區,永煇里,353,198,334,637,19,-439,5.689,-68.917
65000020113,新北市,三重區,永發里,935,499,777,1471,158,-972,20.335,-66.077
65000020088,新北市,三重區,永盛里,510,272,452,784,58,-512,12.832,-65.306
65000020112,新北市,三重區,永吉里,444,190,408,623,36,-433,8.824,-69.502
65000020091,新北市,三重區,永安里,695,301,575,941,120,-640,20.87,-68.013
65000020115,新北市,三重區,永豐里,798,409,739,1325,59,-916,7.984,-69.132
65000020093,新北市,三重區,溪美里,1501,705,1320,2070,181,-1365,13.712,-65.942
65000020094,新北市,三重區,福隆里,678,329,612,1011,66,-682,10.784,-67.458
65000020095,新北市,三重區,五常里,1348,554,615,989,733,-435,119.187,-43.984
65000020097,新北市,三重區,仁忠里,436,184,403,614,33,-430,8.189,-70.033
65000020117,新北市,三重區,福樂里,578,281,502,852,76,-571,15.139,-67.019
65000020119,新北市,三重區,五順里,496,287,517,829,-21,-542,-4.062,-65.38
65000050001,新北市,新莊區,海山里,933,407,886,1233,47,-826,5.305,-66.991
65000050004,新北市,新莊區,全安里,790,360,755,1106,35,-746,4.636,-67.45
65000050060,新北市,新莊區,全泰里,972,379,997,1094,-25,-715,-2.508,-65.356
65000050007,新北市,新莊區,忠孝里,966,346,881,1169,85,-823,9.648,-70.402
65000050010,新北市,新莊區,文衡里,365,159,371,536,-6,-377,-1.617,-70.336
65000050065,新北市,新莊區,文聖里,774,277,681,755,93,-478,13.656,-63.311
65000050013,新北市,新莊區,興漢里,740,286,706,698,34,-412,4.816,-59.026
65000050016,新北市,新莊區,榮和里,596,233,570,726,26,-493,4.561,-67.906
65000050019,新北市,新莊區,文德里,366,118,353,378,13,-260,3.683,-68.783
65000050022,新北市,新莊區,文明里,277,133,263,400,14,-267,5.323,-66.75
65000050036,新北市,新莊區,化成里,676,256,565,924,111,-668,19.646,-72.294
65000050002,新北市,新莊區,頭前里,1982,660,1518,2052,464,-1392,30.567,-67.836
65000050005,新北市,新莊區,福基里,1148,342,913,1105,235,-763,25.739,-69.05
65000050072,新北市,新莊區,福興里,1073,388,935,1343,138,-955,14.759,-71.109
65000050064,新北市,新莊區,昌平里,1857,547,1421,1538,436,-991,30.683,-64.434
65000050033,新北市,新莊區,和平里,659,344,616,1101,43,-757,6.981,-68.756
65000050047,新北市,新莊區,幸福里,636,338,509,986,127,-648,24.951,-65.72
65000050074,新北市,新莊區,昌隆里,896,266,730,926,166,-660,22.74,-71.274
65000050030,新北市,新莊區,信義里,890,365,781,1093,109,-728,13.956,-66.606
65000050073,新北市,新莊區,昌信里,624,245,562,790,62,-545,11.032,-68.987
65000050063,新北市,新莊區,昌明里,648,275,569,805,79,-530,13.884,-65.839
65000050061,新北市,新莊區,仁義里,538,302,454,820,84,-518,18.502,-63.171
65000050028,新北市,新莊區,仁愛里,387,153,353,589,34,-436,9.632,-74.024
65000050049,新北市,新莊區,自信里,407,195,311,554,96,-359,30.868,-64.801
65000050045,新北市,新莊區,自立里,797,352,703,1194,94,-842,13.371,-70.519
65000050042,新北市,新莊區,自強里,371,163,325,516,46,-353,14.154,-68.411
65000050025,新北市,新莊區,思源里,840,393,772,1214,68,-821,8.808,-67.628
65000050039,新北市,新莊區,思賢里,734,331,659,970,75,-639,11.381,-65.876
65000050051,新北市,新莊區,中華里,579,191,468,660,111,-469,23.718,-71.061
65000050011,新北市,新莊區,中美里,1047,428,983,1352,64,-924,6.511,-68.343
65000050008,新北市,新莊區,恆安里,794,319,757,982,37,-663,4.888,-67.515
65000050026,新北市,新莊區,立人里,526,111,502,335,24,-224,4.781,-66.866
65000050029,新北市,新莊區,立德里,457,161,484,563,-27,-402,-5.579,-71.403
65000050014,新北市,新莊區,中和里,789,313,770,1048,19,-735,2.468,-70.134
65000050017,新北市,新莊區,中泰里,660,319,546,1019,114,-700,20.879,-68.695
65000050057,新北市,新莊區,中宏里,655,248,555,788,100,-540,18.018,-68.528
65000050058,新北市,新莊區,中全里,456,227,377,818,79,-591,20.955,-72.249
65000050037,新北市,新莊區,立志里,652,307,553,922,99,-615,17.902,-66.703
65000050076,新北市,新莊區,立廷里,2185,687,1932,2233,253,-1546,13.095,-69.234
65000050062,新北市,新莊區,立基里,1126,447,1097,1369,29,-922,2.644,-67.348
65000050020,新北市,新莊區,中誠里,296,135,263,498,33,-363,12.548,-72.892
65000050023,新北市,新莊區,中港里,997,440,943,1380,54,-940,5.726,-68.116
65000050054,新北市,新莊區,中信里,1358,556,1216,1796,142,-1240,11.678,-69.042
65000050075,新北市,新莊區,中平里,1693,590,1538,1722,155,-1132,10.078,-65.738
65000050053,新北市,新莊區,中原里,2509,847,1975,2549,534,-1702,27.038,-66.771
65000050052,新北市,新莊區,中隆里,1007,370,709,999,298,-629,42.031,-62.963
65000050034,新北市,新莊區,立功里,546,235,482,768,64,-533,13.278,-69.401
65000050059,新北市,新莊區,立泰里,958,358,814,1037,144,-679,17.69,-65.477
65000050031,新北市,新莊區,立言里,849,304,846,1032,3,-728,0.355,-70.543
65000050006,新北市,新莊區,豐年里,535,278,547,809,-12,-531,-2.194,-65.637
65000050003,新北市,新莊區,國泰里,229,72,231,330,-2,-258,-0.866,-78.182
65000050077,新北市,新莊區,泰豐里,503,189,411,545,92,-356,22.384,-65.321
65000050018,新北市,新莊區,瓊林里,779,325,748,1278,31,-953,4.144,-74.57
65000050068,新北市,新莊區,福營里,355,159,399,603,-44,-444,-11.028,-73.632
65000050040,新北市,新莊區,營盤里,289,125,336,434,-47,-309,-13.988,-71.198
65000050043,新北市,新莊區,丹鳳里,1450,458,1317,1594,133,-1136,10.099,-71.267
65000050046,新北市,新莊區,合鳳里,697,276,606,891,91,-615,15.017,-69.024
65000050080,新北市,新莊區,祥鳳里,389,145,379,472,10,-327,2.639,-69.28
65000050048,新北市,新莊區,雙鳳里,2065,618,1769,2032,296,-1414,16.733,-69.587
65000050079,新北市,新莊區,龍福里,412,110,379,414,33,-304,8.707,-73.43
65000050050,新北市,新莊區,龍鳳里,1723,608,1523,1893,200,-1285,13.132,-67.882
65000050021,新北市,新莊區,裕民里,1052,501,915,1483,137,-982,14.973,-66.217
65000050067,新北市,新莊區,龍安里,339,142,319,449,20,-307,6.27,-68.374
65000050024,新北市,新莊區,富國里,394,185,349,505,45,-320,12.894,-63.366
65000050078,新北市,新莊區,富民里,748,244,632,822,116,-578,18.354,-70.316
65000050069,新北市,新莊區,後德里,582,263,547,728,35,-465,6.399,-63.874
65000050066,新北市,新莊區,萬安里,599,214,507,768,92,-554,18.146,-72.135
65000050056,新北市,新莊區,建福里,442,165,393,558,49,-393,12.468,-70.43
65000050009,新北市,新莊區,後港里,1276,585,1128,1652,148,-1067,13.121,-64.588
65000050055,新北市,新莊區,四維里,627,274,573,885,54,-611,9.424,-69.04
65000050027,新北市,新莊區,南港里,839,333,729,1036,110,-703,15.089,-67.857
65000050070,新北市,新莊區,建安里,1083,427,935,1377,148,-950,15.829,-68.991
65000050081,新北市,新莊區,民全里,690,264,569,763,121,-499,21.265,-65.4
65000050012,新北市,新莊區,八德里,447,187,410,610,37,-423,9.024,-69.344
65000050071,新北市,新莊區,成德里,737,280,670,946,67,-666,10.0,-70.402
65000050032,新北市,新莊區,民安里,1041,314,869,1097,172,-783,19.793,-71.376
65000050082,新北市,新莊區,民有里,860,274,687,845,173,-571,25.182,-67.574
65000050035,新北市,新莊區,民本里,426,199,357,650,69,-451,19.328,-69.385
65000050044,新北市,新莊區,光明里,721,261,569,856,152,-595,26.714,-69.509
65000050083,新北市,新莊區,光正里,758,272,606,849,152,-577,25.083,-67.962
65000050041,新北市,新莊區,光榮里,646,208,597,747,49,-539,8.208,-72.155
65000050084,新北市,新莊區,光和里,389,155,319,584,70,-429,21.944,-73.459
65000050038,新北市,新莊區,光華里,1122,381,933,1298,189,-917,20.257,-70.647
65000050015,新北市,新莊區,西盛里,2392,795,1818,2484,574,-1689,31.573,-67.995
65000070003,新北市,樹林區,三興里,709,280,665,903,44,-623,6.617,-68.992
65000070002,新北市,樹林區,三福里,672,257,605,730,67,-473,11.074,-64.795
65000070001,新北市,樹林區,三多里,666,255,538,854,128,-599,23.792,-70.141
65000070042,新北市,樹林區,三龍里,367,111,323,497,44,-386,13.622,-77.666
65000070007,新北市,樹林區,獇寮里,621,289,547,1002,74,-713,13.528,-71.158
65000070031,新北市,樹林區,光興里,630,236,539,818,91,-582,16.883,-71.149
65000070032,新北市,樹林區,金寮里,668,263,568,892,100,-629,17.606,-70.516
65000070006,新北市,樹林區,潭底里,664,279,627,927,37,-648,5.901,-69.903
65000070034,新北市,樹林區,文林里,903,299,833,1007,70,-708,8.403,-70.308
65000070005,新北市,樹林區,保安里,1127,422,1021,1325,106,-903,10.382,-68.151
65000070004,新北市,樹林區,圳安里,611,245,481,850,130,-605,27.027,-71.176
65000070028,新北市,樹林區,圳福里,764,247,675,858,89,-611,13.185,-71.212
65000070040,新北市,樹林區,圳民里,496,175,475,555,21,-380,4.421,-68.468
65000070041,新北市,樹林區,圳生里,235,105,189,421,46,-316,24.339,-75.059
65000070008,新北市,樹林區,樹德里,727,260,693,795,34,-535,4.906,-67.296
65000070030,新北市,樹林區,樹福里,709,277,756,746,-47,-469,-6.217,-62.869
65000070009,新北市,樹林區,樹西里,1026,397,924,1173,102,-776,11.039,-66.155
65000070029,新北市,樹林區,樹興里,666,227,616,715,50,-488,8.117,-68.252
65000070011,新北市,樹林區,樹人里,620,169,629,592,-9,-423,-1.431,-71.453
65000070037,新北市,樹林區,育英里,639,253,559,686,80,-433,14.311,-63.12
65000070010,新北市,樹林區,樹南里,797,287,709,914,88,-627,12.412,-68.6
65000070012,新北市,樹林區,坡內里,317,106,222,363,95,-257,42.793,-70.799
65000070013,新北市,樹林區,樹東里,217,53,219,226,-2,-173,-0.913,-76.549
65000070027,新北市,樹林區,樹北里,205,102,187,240,18,-138,9.626,-57.5
65000070017,新北市,樹林區,彭福里,890,352,766,1047,124,-695,16.188,-66.38
65000070015,新北市,樹林區,和平里,585,246,557,781,28,-535,5.027,-68.502
65000070033,新北市,樹林區,彭興里,815,333,714,1111,101,-778,14.146,-70.027
65000070016,新北市,樹林區,彭厝里,761,324,589,966,172,-642,29.202,-66.46
65000070014,新北市,樹林區,大同里,678,241,636,678,42,-437,6.604,-64.454
65000070038,新北市,樹林區,中華里,585,187,528,579,57,-392,10.795,-67.703
65000070039,新北市,樹林區,太順里,424,144,357,504,67,-360,18.768,-71.429
65000070020,新北市,樹林區,東昇里,919,280,751,1008,168,-728,22.37,-72.222
65000070019,新北市,樹林區,東陽里,956,343,864,1120,92,-777,10.648,-69.375
65000070018,新北市,樹林區,東山里,467,129,449,647,18,-518,4.009,-80.062
65000070035,新北市,樹林區,山佳里,920,348,773,1102,147,-754,19.017,-68.421
65000070036,新北市,樹林區,中山里,870,367,745,1088,125,-721,16.779,-66.268
65000070021,新北市,樹林區,樂山里,334,135,262,365,72,-230,27.481,-63.014
65000070026,新北市,樹林區,柑園里,2088,511,1804,1680,284,-1169,15.743,-69.583
65000070023,新北市,樹林區,西園里,222,95,202,434,20,-339,9.901,-78.111
65000070024,新北市,樹林區,南園里,3070,770,2808,2450,262,-1680,9.33,-68.571
65000070022,新北市,樹林區,東園里,246,106,179,424,67,-318,37.43,-75.0
65000070025,新北市,樹林區,北園里,307,167,250,538,57,-371,22.8,-68.959
65000080006,新北市,鶯歌區,建德里,111,34,100,140,11,-106,11.0,-75.714
65000080001,新北市,鶯歌區,東鶯里,196,91,190,249,6,-158,3.158,-63.454
65000080004,新北市,鶯歌區,北鶯里,773,284,724,759,49,-475,6.768,-62.582
65000080002,新北市,鶯歌區,西鶯里,446,175,401,462,45,-287,11.222,-62.121
65000080005,新北市,鶯歌區,中鶯里,166,63,198,266,-32,-203,-16.162,-76.316
65000080003,新北市,鶯歌區,南鶯里,960,380,922,1213,38,-833,4.121,-68.673
65000080020,新北市,鶯歌區,建國里,1133,401,964,1340,169,-939,17.531,-70.075
65000080012,新北市,鶯歌區,二甲里,184,75,156,220,28,-145,17.949,-65.909
65000080011,新北市,鶯歌區,二橋里,1410,440,1105,1552,305,-1112,27.602,-71.649
65000080010,新北市,鶯歌區,尖山里,1663,537,1276,1670,387,-1133,30.329,-67.844
65000080009,新北市,鶯歌區,南靖里,551,251,507,811,44,-560,8.679,-69.051
65000080007,新北市,鶯歌區,同慶里,256,106,259,377,-3,-271,-1.158,-71.883
65000080008,新北市,鶯歌區,永昌里,1472,432,1276,1566,196,-1134,15.361,-72.414
65000080017,新北市,鶯歌區,永吉里,906,310,810,900,96,-590,11.852,-65.556
65000080019,新北市,鶯歌區,鳳祥里,736,279,633,817,103,-538,16.272,-65.851
65000080015,新北市,鶯歌區,鳳鳴里,1284,387,773,984,511,-597,66.106,-60.671
65000080016,新北市,鶯歌區,鳳福里,908,295,653,820,255,-525,39.051,-64.024
65000080014,新北市,鶯歌區,大湖里,1045,340,901,972,144,-632,15.982,-65.021
65000080018,新北市,鶯歌區,中湖里,932,284,855,972,77,-688,9.006,-70.782
65000080013,新北市,鶯歌區,東湖里,60,18,60,89,0,-71,0.0,-79.775
65000010001,新北市,板橋區,留侯里,341,118,388,311,-47,-193,-12.113,-62.058
65000010002,新北市,板橋區,流芳里,227,104,253,306,-26,-202,-10.277,-66.013
65000010003,新北市,板橋區,赤松里,197,87,208,213,-11,-126,-5.288,-59.155
65000010004,新北市,板橋區,黃石里,202,95,190,274,12,-179,6.316,-65.328
65000010005,新北市,板橋區,挹秀里,401,127,477,352,-76,-225,-15.933,-63.92
65000010006,新北市,板橋區,湳興里,1034,371,902,1006,132,-635,14.634,-63.121
65000010007,新北市,板橋區,新興里,575,228,523,616,52,-388,9.943,-62.987
65000010008,新北市,板橋區,社後里,1173,472,1151,1319,22,-847,1.911,-64.215
65000010009,新北市,板橋區,香社里,763,349,728,1006,35,-657,4.808,-65.308
65000010101,新北市,板橋區,香雅里,589,198,465,562,124,-364,26.667,-64.769
65000010010,新北市,板橋區,中正里,1434,435,827,1046,607,-611,73.398,-58.413
65000010011,新北市,板橋區,自強里,1184,375,1268,1061,-84,-686,-6.625,-64.656
65000010012,新北市,板橋區,自立里,533,243,468,686,65,-443,13.889,-64.577
65000010013,新北市,板橋區,光華里,532,219,560,543,-28,-324,-5.0,-59.669
65000010114,新北市,板橋區,光榮里,541,182,524,504,17,-322,3.244,-63.889
65000010014,新北市,板橋區,國光里,1087,210,1238,554,-151,-344,-12.197,-62.094
65000010015,新北市,板橋區,港尾里,596,211,590,635,6,-424,1.017,-66.772
65000010102,新北市,板橋區,新生里,695,327,691,965,4,-638,0.579,-66.114
65000010016,新北市,板橋區,金華里,601,277,620,836,-19,-559,-3.065,-66.866
65000010017,新北市,板橋區,港德里,697,319,688,1007,9,-688,1.308,-68.322
65000010018,新北市,板橋區,民權里,598,213,570,569,28,-356,4.912,-62.566
65000010115,新北市,板橋區,民安里,414,205,406,428,8,-223,1.97,-52.103
65000010019,新北市,板橋區,建國里,559,321,575,845,-16,-524,-2.783,-62.012
65000010020,新北市,板橋區,漢生里,884,331,839,954,45,-623,5.364,-65.304
65000010021,新北市,板橋區,公舘里,635,284,588,878,47,-594,7.993,-67.654
65000010022,新北市,板橋區,新民里,742,276,772,889,-30,-613,-3.886,-68.954
65000010023,新北市,板橋區,幸福里,625,285,579,824,46,-539,7.945,-65.413
65000010103,新北市,板橋區,文德里,677,255,554,637,123,-382,22.202,-59.969
65000010024,新北市,板橋區,忠誠里,1226,235,1255,607,-29,-372,-2.311,-61.285
65000010116,新北市,板橋區,陽明里,437,199,429,696,8,-497,1.865,-71.408
65000010025,新北市,板橋區,百壽里,468,177,465,570,3,-393,0.645,-68.947
65000010026,新北市,板橋區,介壽里,495,185,513,562,-18,-377,-3.509,-67.082
65000010027,新北市,板橋區,新埔里,371,211,367,565,4,-354,1.09,-62.655
65000010028,新北市,板橋區,華江里,1419,513,1289,1531,130,-1018,10.085,-66.492
65000010029,新北市,板橋區,江翠里,798,360,731,1195,67,-835,9.166,-69.874
65000010030,新北市,板橋區,純翠里,877,363,784,1202,93,-839,11.862,-69.8
65000010031,新北市,板橋區,溪頭里,1902,680,985,1446,917,-766,93.096,-52.974
65000010032,新北市,板橋區,聯翠里,718,270,716,740,2,-470,0.279,-63.514
65000010104,新北市,板橋區,文化里,570,226,519,810,51,-584,9.827,-72.099
65000010033,新北市,板橋區,宏翠里,1224,411,917,1070,307,-659,33.479,-61.589
65000010034,新北市,板橋區,仁翠里,422,248,386,739,36,-491,9.326,-66.441
65000010035,新北市,板橋區,新翠里,1426,537,1305,1866,121,-1329,9.272,-71.222
65000010117,新北市,板橋區,朝陽里,496,236,437,790,59,-554,13.501,-70.127
65000010036,新北市,板橋區,吉翠里,595,348,574,925,21,-577,3.659,-62.378
65000010037,新北市,板橋區,德翠里,1460,485,1303,1452,157,-967,12.049,-66.598
65000010105,新北市,板橋區,新海里,552,215,516,773,36,-558,6.977,-72.186
65000010038,新北市,板橋區,滿翠里,410,231,384,739,26,-508,6.771,-68.742
65000010039,新北市,板橋區,明翠里,763,340,744,1085,19,-745,2.554,-68.664
65000010040,新北市,板橋區,松翠里,493,236,504,794,-11,-558,-2.183,-70.277
65000010041,新北市,板橋區,柏翠里,1172,397,745,1031,427,-634,57.315,-61.494
65000010042,新北市,板橋區,龍翠里,823,411,759,1141,64,-730,8.432,-63.979
65000010118,新北市,板橋區,松柏里,454,180,381,572,73,-392,19.16,-68.531
65000010043,新北市,板橋區,華翠里,575,293,571,850,4,-557,0.701,-65.529
65000010106,新北市,板橋區,莒光里,466,207,457,675,9,-468,1.969,-69.333
65000010044,新北市,板橋區,忠翠里,2041,668,1937,2214,104,-1546,5.369,-69.828
65000010045,新北市,板橋區,嵐翠里,373,208,329,593,44,-385,13.374,-64.924
65000010119,新北市,板橋區,文聖里,654,321,560,937,94,-616,16.786,-65.742
65000010046,新北市,板橋區,文翠里,717,284,657,905,60,-621,9.132,-68.619
65000010047,新北市,板橋區,青翠里,492,229,431,688,61,-459,14.153,-66.715
65000010048,新北市,板橋區,懷翠里,904,406,800,1285,104,-879,13.0,-68.405
65000010049,新北市,板橋區,福翠里,264,82,248,286,16,-204,6.452,-71.329
65000010050,新北市,板橋區,港嘴里,1069,494,962,1322,107,-828,11.123,-62.632
65000010061,新北市,板橋區,埤墘里,801,340,736,1056,65,-716,8.832,-67.803
65000010121,新北市,板橋區,莊敬里,838,288,772,891,66,-603,8.549,-67.677
65000010062,新北市,板橋區,永安里,668,306,512,815,156,-509,30.469,-62.454
65000010051,新北市,板橋區,振興里,841,335,764,1039,77,-704,10.079,-67.757
65000010052,新北市,板橋區,振義里,729,358,650,1026,79,-668,12.154,-65.107
65000010053,新北市,板橋區,光復里,610,233,535,749,75,-516,14.019,-68.892
65000010054,新北市,板橋區,埔墘里,1206,519,1015,1369,191,-850,18.818,-62.089
65000010107,新北市,板橋區,富貴里,463,153,439,564,24,-411,5.467,-72.872
65000010055,新北市,板橋區,長壽里,470,198,480,708,-10,-510,-2.083,-72.034
65000010056,新北市,板橋區,福壽里,708,229,663,646,45,-417,6.787,-64.551
65000010120,新北市,板橋區,居仁里,635,220,589,845,46,-625,7.81,-73.964
65000010057,新北市,板橋區,海山里,1401,471,1305,1634,96,-1163,7.356,-71.175
65000010058,新北市,板橋區,九如里,486,243,395,685,91,-442,23.038,-64.526
65000010108,新北市,板橋區,正泰里,547,258,527,696,20,-438,3.795,-62.931
65000010059,新北市,板橋區,玉光里,939,370,775,1100,164,-730,21.161,-66.364
65000010060,新北市,板橋區,光仁里,542,218,490,631,52,-413,10.612,-65.452
65000010063,新北市,板橋區,雙玉里,660,322,653,926,7,-604,1.072,-65.227
65000010064,新北市,板橋區,廣新里,561,195,522,697,39,-502,7.471,-72.023
65000010065,新北市,板橋區,深丘里,1585,479,1604,1611,-19,-1132,-1.185,-70.267
65000010066,新北市,板橋區,香丘里,590,252,565,780,25,-528,4.425,-67.692
65000010067,新北市,板橋區,西安里,450,178,440,578,10,-400,2.273,-69.204
65000010068,新北市,板橋區,東丘里,726,289,687,1079,39,-790,5.677,-73.216
65000010109,新北市,板橋區,民生里,397,194,356,548,41,-354,11.517,-64.599
65000010069,新北市,板橋區,長安里,779,318,673,1074,106,-756,15.75,-70.391
65000010122,新北市,板橋區,東安里,360,181,330,495,30,-314,9.091,-63.434
65000010070,新北市,板橋區,福丘里,1048,292,1050,953,-2,-661,-0.19,-69.36
65000010071,新北市,板橋區,福祿里,826,221,775,690,51,-469,6.581,-67.971
65000010072,新北市,板橋區,民族里,862,293,803,955,59,-662,7.347,-69.319
65000010073,新北市,板橋區,國泰里,696,238,698,727,-2,-489,-0.287,-67.263
65000010110,新北市,板橋區,後埔里,794,252,735,791,59,-539,8.027,-68.142
65000010074,新北市,板橋區,福德里,976,328,903,1130,73,-802,8.084,-70.973
65000010075,新北市,板橋區,景星里,744,280,620,664,124,-384,20.0,-57.831
65000010076,新北市,板橋區,福星里,701,270,697,814,4,-544,0.574,-66.83
65000010077,新北市,板橋區,鄉雲里,750,275,754,800,-4,-525,-0.531,-65.625
65000010078,新北市,板橋區,廣德里,1285,395,1248,1380,37,-985,2.965,-71.377
65000010079,新北市,板橋區,大豐里,950,307,908,896,42,-589,4.626,-65.737
65000010080,新北市,板橋區,重慶里,1558,463,1501,1611,57,-1148,3.797,-71.26
65000010081,新北市,板橋區,仁愛里,777,199,699,538,78,-339,11.159,-63.011
65000010082,新北市,板橋區,和平里,824,198,769,634,55,-436,7.152,-68.77
65000010083,新北市,板橋區,廣福里,617,212,597,738,20,-526,3.35,-71.274
65000010123,新北市,板橋區,五權里,754,286,692,890,62,-604,8.96,-67.865
65000010084,新北市,板橋區,華興里,816,294,794,914,22,-620,2.771,-67.834
65000010085,新北市,板橋區,華貴里,376,153,435,602,-59,-449,-13.563,-74.585
65000010111,新北市,板橋區,華福里,394,116,383,438,11,-322,2.872,-73.516
65000010086,新北市,板橋區,華德里,1310,413,1169,1279,141,-866,12.062,-67.709
65000010087,新北市,板橋區,華東里,1878,476,1772,1576,106,-1100,5.982,-69.797
65000010088,新北市,板橋區,信義里,803,284,744,854,59,-570,7.93,-66.745
65000010089,新北市,板橋區,浮洲里,509,242,507,845,2,-603,0.394,-71.361
65000010090,新北市,板橋區,華中里,803,386,749,1174,54,-788,7.21,-67.121
65000010091,新北市,板橋區,僑中里,635,279,557,880,78,-601,14.004,-68.295
65000010125,新北市,板橋區,大觀里,522,237,458,787,64,-550,13.974,-69.886
65000010126,新北市,板橋區,歡園里,184,74,186,312,-2,-238,-1.075,-76.282
65000010092,新北市,板橋區,中山里,1314,394,1240,1266,74,-872,5.968,-68.878
65000010093,新北市,板橋區,復興里,251,64,242,188,9,-124,3.719,-65.957
65000010094,新北市,板橋區,大安里,694,277,634,838,60,-561,9.464,-66.945
65000010095,新北市,板橋區,福安里,1596,433,1335,1303,261,-870,19.551,-66.769
65000010096,新北市,板橋區,聚安里,811,339,725,1060,86,-721,11.862,-68.019
65000010097,新北市,板橋區,龍安里,461,245,424,644,37,-399,8.726,-61.957
65000010098,新北市,板橋區,崑崙里,1878,553,1488,1845,390,-1292,26.21,-70.027
65000010113,新北市,板橋區,成和里,1154,360,985,1183,169,-823,17.157,-69.569
65000010099,新北市,板橋區,溪洲里,931,345,837,1177,94,-832,11.231,-70.688
65000010124,新北市,板橋區,溪福里,2602,699,2185,2533,417,-1834,19.085,-72.404
65000010100,新北市,板橋區,溪北里,678,265,565,728,113,-463,20.0,-63.599
65000010112,新北市,板橋區,堂春里,709,293,652,813,57,-520,8.742,-63.961
65000030001,新北市,中和區,中原里,1991,504,1348,1345,643,-841,47.7,-62.528
65000030007,新北市,中和區,連和里,758,154,663,363,95,-209,14.329,-57.576
65000030008,新北市,中和區,連城里,1616,341,1597,1121,19,-780,1.19,-69.581
65000030009,新北市,中和區,力行里,1440,373,1314,1208,126,-835,9.589,-69.123
65000030093,新北市,中和區,正行里,645,168,633,541,12,-373,1.896,-68.946
65000030073,新北市,中和區,德行里,1590,402,1578,1235,12,-833,0.76,-67.449
65000030010,新北市,中和區,枋寮里,783,245,768,740,15,-495,1.953,-66.892
65000030011,新北市,中和區,漳和里,781,263,834,735,-53,-472,-6.355,-64.218
65000030012,新北市,中和區,廟美里,921,279,924,878,-3,-599,-0.325,-68.223
65000030013,新北市,中和區,福真里,836,250,845,840,-9,-590,-1.065,-70.238
65000030014,新北市,中和區,福善里,959,307,928,859,31,-552,3.341,-64.261
65000030015,新北市,中和區,福美里,981,297,986,882,-5,-585,-0.507,-66.327
65000030016,新北市,中和區,福祥里,1134,403,1052,1075,82,-672,7.795,-62.512
65000030017,新北市,中和區,瓦磘里,1009,260,1052,1025,-43,-765,-4.087,-74.634
65000030018,新北市,中和區,福和里,797,241,765,725,32,-484,4.183,-66.759
65000030019,新北市,中和區,佳和里,1110,319,1097,992,13,-673,1.185,-67.843
65000030025,新北市,中和區,新南里,1863,408,1788,1514,75,-1106,4.195,-73.052
65000030026,新北市,中和區,南山里,1192,300,1226,930,-34,-630,-2.773,-67.742
65000030002,新北市,中和區,平河里,2191,511,1906,1726,285,-1215,14.953,-70.394
65000030003,新北市,中和區,信和里,802,301,803,902,-1,-601,-0.125,-66.63
65000030004,新北市,中和區,仁和里,837,230,723,683,114,-453,15.768,-66.325
65000030005,新北市,中和區,中正里,791,241,657,693,134,-452,20.396,-65.224
65000030006,新北市,中和區,建和里,957,194,943,608,14,-414,1.485,-68.092
65000030083,新北市,中和區,中山里,505,153,480,518,25,-365,5.208,-70.463
65000030084,新北市,中和區,碧河里,1263,355,1055,983,208,-628,19.716,-63.886
65000030092,新北市,中和區,正南里,785,156,824,463,-39,-307,-4.733,-66.307
65000030034,新北市,中和區,頂南里,863,163,798,453,65,-290,8.145,-64.018
65000030035,新北市,中和區,華新里,1792,343,1697,1033,95,-690,5.598,-66.796
65000030036,新北市,中和區,東南里,1158,148,1329,461,-171,-313,-12.867,-67.896
65000030037,新北市,中和區,華南里,1296,232,1285,718,11,-486,0.856,-67.688
65000030038,新北市,中和區,忠孝里,1146,223,1097,612,49,-389,4.467,-63.562
65000030039,新北市,中和區,崇南里,1163,259,1212,692,-49,-433,-4.043,-62.572
65000030078,新北市,中和區,興南里,738,159,761,489,-23,-330,-3.022,-67.485
65000030040,新北市,中和區,景南里,733,165,766,474,-33,-309,-4.308,-65.19
65000030079,新北市,中和區,景本里,495,148,543,389,-48,-241,-8.84,-61.954
65000030041,新北市,中和區,橫路里,62,15,61,81,1,-66,1.639,-81.481
65000030042,新北市,中和區,內南里,1115,248,1133,755,-18,-507,-1.589,-67.152
65000030043,新北市,中和區,壽南里,605,161,550,414,55,-253,10.0,-61.111
65000030080,新北市,中和區,福南里,1151,200,1084,587,67,-387,6.181,-65.928
65000030044,新北市,中和區,外南里,862,222,879,743,-17,-521,-1.934,-70.121
65000030081,新北市,中和區,中興里,1506,327,1512,1134,-6,-807,-0.397,-71.164
65000030082,新北市,中和區,吉興里,718,139,723,469,-5,-330,-0.692,-70.362
65000030045,新北市,中和區,復興里,1152,294,1166,917,-14,-623,-1.201,-67.939
65000030046,新北市,中和區,和興里,1087,280,1087,806,0,-526,0.0,-65.261
65000030047,新北市,中和區,景平里,1656,403,1438,944,218,-541,15.16,-57.309
65000030048,新北市,中和區,景新里,892,249,886,654,6,-405,0.677,-61.927
65000030049,新北市,中和區,景福里,1573,344,1427,947,146,-603,10.231,-63.675
65000030050,新北市,中和區,景安里,1313,314,1307,885,6,-571,0.459,-64.52
65000030051,新北市,中和區,景文里,1024,239,952,663,72,-424,7.563,-63.952
65000030052,新北市,中和區,錦和里,1112,338,1124,988,-12,-650,-1.068,-65.789
65000030053,新北市,中和區,錦昌里,538,118,573,375,-35,-257,-6.108,-68.533
65000030054,新北市,中和區,灰磘里,181,44,117,160,64,-116,54.701,-72.5
65000030055,新北市,中和區,積穗里,1854,561,1753,1699,101,-1138,5.762,-66.981
65000030056,新北市,中和區,民享里,522,262,447,634,75,-372,16.779,-58.675
65000030057,新北市,中和區,員山里,1350,422,1172,1259,178,-837,15.188,-66.481
65000030058,新北市,中和區,嘉穗里,600,189,534,577,66,-388,12.36,-67.244
65000030059,新北市,中和區,文元里,930,328,923,1114,7,-786,0.758,-70.557
65000030060,新北市,中和區,嘉新里,710,217,694,773,16,-556,2.305,-71.928
65000030061,新北市,中和區,民安里,971,271,913,1059,58,-788,6.353,-74.41
65000030062,新北市,中和區,安穗里,806,307,758,952,48,-645,6.332,-67.752
65000030063,新北市,中和區,瑞穗里,503,129,522,457,-19,-328,-3.64,-71.772
65000030064,新北市,中和區,明穗里,804,291,840,992,-36,-701,-4.286,-70.665
65000030065,新北市,中和區,清穗里,653,243,611,692,42,-449,6.874,-64.884
65000030066,新北市,中和區,自強里,899,309,823,1032,76,-723,9.235,-70.058
65000030067,新北市,中和區,德穗里,1008,306,928,890,80,-584,8.621,-65.618
65000030068,新北市,中和區,民生里,925,304,848,897,77,-593,9.08,-66.109
65000030069,新北市,中和區,國光里,827,257,808,782,19,-525,2.351,-67.136
65000030070,新北市,中和區,壽德里,1340,211,1274,676,66,-465,5.181,-68.787
65000030071,新北市,中和區,明德里,717,243,640,790,77,-547,12.031,-69.241
65000030085,新北市,中和區,錦中里,789,230,790,762,-1,-532,-0.127,-69.816
65000030086,新北市,中和區,錦盛里,782,277,679,805,103,-528,15.169,-65.59
65000030087,新北市,中和區,民有里,618,206,574,602,44,-396,7.666,-65.781
65000030088,新北市,中和區,員富里,730,277,618,739,112,-462,18.123,-62.517
65000030089,新北市,中和區,嘉慶里,736,185,708,799,28,-614,3.955,-76.846
65000030090,新北市,中和區,冠穗里,716,276,651,803,65,-527,9.985,-65.629
65000030091,新北市,中和區,國華里,654,250,602,710,52,-460,8.638,-64.789
65000030074,新北市,中和區,宜安里,572,134,526,337,46,-203,8.745,-60.237
65000030020,新北市,中和區,安樂里,999,234,1033,650,-34,-416,-3.291,-64.0
65000030021,新北市,中和區,安和里,776,260,793,617,-17,-357,-2.144,-57.861
65000030075,新北市,中和區,安順里,1169,292,1195,781,-26,-489,-2.176,-62.612
65000030022,新北市,中和區,安平里,1667,363,1688,1004,-21,-641,-1.244,-63.845
65000030023,新北市,中和區,中安里,1319,218,1316,767,3,-549,0.228,-71.578
65000030024,新北市,中和區,泰安里,762,235,797,668,-35,-433,-4.391,-64.82
65000030027,新北市,中和區,秀山里,1034,267,1089,774,-55,-507,-5.051,-65.504
65000030028,新北市,中和區,秀成里,768,229,814,621,-46,-392,-5.651,-63.124
65000030076,新北市,中和區,秀義里,623,183,639,551,-16,-368,-2.504,-66.788
65000030029,新北市,中和區,秀福里,1078,269,1175,886,-97,-617,-8.255,-69.639
65000030030,新北市,中和區,秀景里,1694,377,1733,1033,-39,-656,-2.25,-63.504
65000030031,新北市,中和區,秀明里,1489,262,1405,719,84,-457,5.979,-63.561
65000030032,新北市,中和區,秀峰里,1271,284,1235,798,36,-514,2.915,-64.411
65000030077,新北市,中和區,秀士里,593,89,633,375,-40,-286,-6.319,-76.267
65000030072,新北市,中和區,秀水里,917,174,920,546,-3,-372,-0.326,-68.132
65000030033,新北市,中和區,秀仁里,734,182,788,513,-54,-331,-6.853,-64.522
65000040036,新北市,永和區,光復里,391,100,426,287,-35,-187,-8.216,-65.157
65000040052,新北市,永和區,網溪里,271,29,302,163,-31,-134,-10.265,-82.209
65000040037,新北市,永和區,復興里,582,125,647,393,-65,-268,-10.046,-68.193
65000040023,新北市,永和區,竹林里,822,182,937,562,-115,-380,-12.273,-67.616
65000040055,新北市,永和區,桂林里,869,176,956,536,-87,-360,-9.1,-67.164
65000040051,新北市,永和區,上林里,869,171,988,534,-119,-363,-12.045,-67.978
65000040001,新北市,永和區,福林里,730,183,793,576,-63,-393,-7.945,-68.229
65000040019,新北市,永和區,勵行里,253,69,226,265,27,-196,11.947,-73.962
65000040018,新北市,永和區,中興里,741,159,762,545,-21,-386,-2.756,-70.826
65000040054,新北市,永和區,永興里,653,132,774,512,-121,-380,-15.633,-74.219
65000040053,新北市,永和區,正興里,481,119,558,367,-77,-248,-13.799,-67.575
65000040003,新北市,永和區,豫溪里,914,200,948,607,-34,-407,-3.586,-67.051
65000040004,新北市,永和區,光明里,734,181,813,522,-79,-341,-9.717,-65.326
65000040038,新北市,永和區,福和里,1241,270,1343,860,-102,-590,-7.595,-68.605
65000040039,新北市,永和區,得和里,989,228,1233,701,-244,-473,-19.789,-67.475
65000040006,新北市,永和區,永貞里,790,191,829,636,-39,-445,-4.704,-69.969
65000040007,新北市,永和區,永福里,711,182,728,515,-17,-333,-2.335,-64.66
65000040048,新北市,永和區,河濱里,769,191,777,549,-8,-358,-1.03,-65.209
65000040047,新北市,永和區,秀和里,1117,273,1216,878,-99,-605,-8.141,-68.907
65000040011,新北市,永和區,永元里,1049,286,1146,833,-97,-547,-8.464,-65.666
65000040017,新北市,永和區,民權里,1015,205,1081,755,-66,-550,-6.105,-72.848
65000040016,新北市,永和區,民族里,1085,255,1159,776,-74,-521,-6.385,-67.139
65000040020,新北市,永和區,秀朗里,817,222,834,684,-17,-462,-2.038,-67.544
65000040021,新北市,永和區,秀成里,636,151,667,528,-31,-377,-4.648,-71.402
65000040012,新北市,永和區,秀林里,938,263,881,839,57,-576,6.47,-68.653
65000040050,新北市,永和區,秀得里,582,129,637,436,-55,-307,-8.634,-70.413
65000040060,新北市,永和區,秀元里,682,202,734,534,-52,-332,-7.084,-62.172
65000040049,新北市,永和區,民生里,819,204,926,688,-107,-484,-11.555,-70.349
65000040034,新北市,永和區,民本里,760,185,861,647,-101,-462,-11.731,-71.406
65000040059,新北市,永和區,民富里,597,130,677,476,-80,-346,-11.817,-72.689
65000040035,新北市,永和區,民樂里,1198,260,1285,766,-87,-506,-6.77,-66.057
65000040008,新北市,永和區,民治里,568,121,645,418,-77,-297,-11.938,-71.053
65000040040,新北市,永和區,智光里,686,166,724,495,-38,-329,-5.249,-66.465
65000040031,新北市,永和區,潭安里,1164,192,1266,734,-102,-542,-8.057,-73.842
65000040030,新北市,永和區,潭墘里,1115,221,1264,711,-149,-490,-11.788,-68.917
65000040056,新北市,永和區,店街里,922,170,971,671,-49,-501,-5.046,-74.665
65000040032,新北市,永和區,大新里,659,153,684,467,-25,-314,-3.655,-67.238
65000040015,新北市,永和區,永安里,994,236,1142,731,-148,-495,-12.96,-67.715
65000040061,新北市,永和區,永樂里,496,125,517,461,-21,-336,-4.062,-72.885
65000040026,新北市,永和區,水源里,947,242,1045,742,-98,-500,-9.378,-67.385
65000040027,新北市,永和區,協和里,609,154,726,546,-117,-392,-16.116,-71.795
65000040024,新北市,永和區,雙和里,966,228,1027,734,-61,-506,-5.94,-68.937
65000040025,新北市,永和區,安和里,999,241,991,672,8,-431,0.807,-64.137
65000040043,新北市,永和區,前溪里,518,128,572,339,-54,-211,-9.441,-62.242
65000040044,新北市,永和區,和平里,968,236,1114,825,-146,-589,-13.106,-71.394
65000040033,新北市,永和區,保平里,989,294,1106,919,-117,-625,-10.579,-68.009
65000040014,新北市,永和區,中溪里,1127,286,1163,954,-36,-668,-3.095,-70.021
65000040013,新北市,永和區,保安里,1486,381,1717,1328,-231,-947,-13.454,-71.31
65000040062,新北市,永和區,保順里,2355,497,2407,1728,-52,-1231,-2.16,-71.238
65000040046,新北市,永和區,下溪里,1083,282,1077,830,6,-548,0.557,-66.024
65000040042,新北市,永和區,大同里,271,32,318,125,-47,-93,-14.78,-74.4
65000040041,新北市,永和區,新生里,264,25,269,113,-5,-88,-1.859,-77.876
65000040009,新北市,永和區,永成里,261,15,321,90,-60,-75,-18.692,-83.333
65000040010,新北市,永和區,忠義里,228,21,278,69,-50,-48,-17.986,-69.565
65000040005,新北市,永和區,仁愛里,673,179,720,509,-47,-330,-6.528,-64.833
65000040002,新北市,永和區,文化里,663,132,722,467,-59,-335,-8.172,-71.734
65000040057,新北市,永和區,信義里,611,178,676,480,-65,-302,-9.615,-62.917
65000040058,新北市,永和區,後溪里,473,161,469,430,4,-269,0.853,-62.558
65000040022,新北市,永和區,上溪里,459,120,430,353,29,-233,6.744,-66.006
65000040029,新北市,永和區,頂溪里,600,137,648,467,-48,-330,-7.407,-70.664
65000040028,新北市,永和區,河堤里,712,160,842,539,-130,-379,-15.439,-70.315
65000040045,新北市,永和區,新廍里,579,128,602,409,-23,-281,-3.821,-68.704
65000130026,新北市,土城區,祖田里,281,114,203,367,78,-253,38.424,-68.937
65000130025,新北市,土城區,頂新里,716,144,713,439,3,-295,0.421,-67.198
65000130024,新北市,土城區,頂福里,999,329,851,947,148,-618,17.391,-65.259
65000130023,新北市,土城區,頂埔里,946,320,808,911,138,-591,17.079,-64.874
65000130022,新北市,土城區,沛陂里,967,366,749,976,218,-610,29.105,-62.5
65000130021,新北市,土城區,永寧里,1432,453,1260,1414,172,-961,13.651,-67.963
65000130020,新北市,土城區,大安里,1011,352,862,990,149,-638,17.285,-64.444
65000130004,新北市,土城區,員仁里,987,305,866,979,121,-674,13.972,-68.846
65000130001,新北市,土城區,埤塘里,580,206,584,703,-4,-497,-0.685,-70.697
65000130002,新北市,土城區,土城里,374,125,351,390,23,-265,6.553,-67.949
65000130005,新北市,土城區,長風里,681,102,714,275,-33,-173,-4.622,-62.909
65000130037,新北市,土城區,員信里,834,224,691,753,143,-529,20.695,-70.252
65000130003,新北市,土城區,員林里,1849,510,1281,1298,568,-788,44.34,-60.709
65000130033,新北市,土城區,員福里,936,307,883,1056,53,-749,6.002,-70.928
65000130007,新北市,土城區,日和里,1601,549,1010,1362,591,-813,58.515,-59.692
65000130006,新北市,土城區,日新里,773,299,737,978,36,-679,4.885,-69.427
65000130036,新北市,土城區,裕生里,923,358,825,1155,98,-797,11.879,-69.004
65000130008,新北市,土城區,貨饒里,822,315,646,965,176,-650,27.245,-67.358
65000130011,新北市,土城區,瑞興里,481,215,405,670,76,-455,18.765,-67.91
65000130035,新北市,土城區,復興里,797,287,742,889,55,-602,7.412,-67.717
65000130028,新北市,土城區,廣福里,1160,333,1071,1141,89,-808,8.31,-70.815
65000130039,新北市,土城區,學成里,626,249,523,771,103,-522,19.694,-67.704
65000130010,新北市,土城區,埤林里,1612,524,1514,1654,98,-1130,6.473,-68.319
65000130044,新北市,土城區,廣興里,665,217,592,650,73,-433,12.331,-66.615
65000130027,新北市,土城區,樂利里,882,289,841,995,41,-706,4.875,-70.955
65000130029,新北市,土城區,學府里,621,216,580,690,41,-474,7.069,-68.696
65000130043,新北市,土城區,明德里,1311,327,1094,1106,217,-779,19.835,-70.434
65000130042,新北市,土城區,學士里,940,324,904,978,36,-654,3.982,-66.871
65000130009,新北市,土城區,柑林里,892,256,621,705,271,-449,43.639,-63.688
65000130041,新北市,土城區,中正里,565,200,572,638,-7,-438,-1.224,-68.652
65000130032,新北市,土城區,青雲里,757,224,531,637,226,-413,42.561,-64.835
65000130013,新北市,土城區,清和里,1053,371,830,1141,223,-770,26.867,-67.485
65000130015,新北市,土城區,清化里,257,96,233,343,24,-247,10.3,-72.012
65000130016,新北市,土城區,清溪里,1191,369,1172,1254,19,-885,1.621,-70.574
65000130045,新北市,土城區,青山里,540,206,463,615,77,-409,16.631,-66.504
65000130012,新北市,土城區,清水里,1344,478,1269,1540,75,-1062,5.91,-68.961
65000130014,新北市,土城區,永豐里,811,281,749,743,62,-462,8.278,-62.18
65000130038,新北市,土城區,永富里,952,306,831,983,121,-677,14.561,-68.871
65000130019,新北市,土城區,廷寮里,906,321,725,1017,181,-696,24.966,-68.437
65000130046,新北市,土城區,金城里,1109,296,1064,929,45,-633,4.229,-68.138
65000130017,新北市,土城區,峯廷里,1112,427,1027,1341,85,-914,8.277,-68.158
65000130034,新北市,土城區,延吉里,643,271,584,853,59,-582,10.103,-68.23
65000130030,新北市,土城區,延壽里,683,263,684,843,-1,-580,-0.146,-68.802
65000130047,新北市,土城區,延祿里,555,219,561,734,-6,-515,-1.07,-70.163
65000130018,新北市,土城區,平和里,1234,453,1053,1429,181,-976,17.189,-68.3
65000130031,新北市,土城區,安和里,895,326,769,1048,126,-722,16.385,-68.893
65000130040,新北市,土城區,延和里,1121,423,1154,1202,-33,-779,-2.86,-64.809
65000090001,新北市,三峽區,三峽里,60,23,73,88,-13,-65,-17.808,-73.864
65000090002,新北市,三峽區,秀川里,117,54,95,132,22,-78,23.158,-59.091
65000090003,新北市,三峽區,八張里,712,219,629,724,83,-505,13.196,-69.751
65000090004,新北市,三峽區,中埔里,666,167,558,503,108,-336,19.355,-66.799
65000090005,新北市,三峽區,弘道里,177,60,125,241,52,-181,41.6,-75.104
65000090006,新北市,三峽區,永舘里,1204,452,1158,1390,46,-938,3.972,-67.482
65000090008,新北市,三峽區,鳶山里,1584,432,1388,1679,196,-1247,14.121,-74.27
65000090009,新北市,三峽區,龍埔里,1862,497,1509,1582,353,-1085,23.393,-68.584
65000090028,新北市,三峽區,龍恩里,1622,378,1325,1079,297,-701,22.415,-64.968
65000090027,新北市,三峽區,龍學里,3331,708,3050,2426,281,-1718,9.213,-70.816
65000090007,新北市,三峽區,礁溪里,1066,366,902,1018,164,-652,18.182,-64.047
65000090024,新北市,三峽區,安溪里,1309,342,1149,1170,160,-828,13.925,-70.769
65000090023,新北市,三峽區,介壽里,1009,350,895,1111,114,-761,12.737,-68.497
65000090025,新北市,三峽區,中正里,820,221,710,871,110,-650,15.493,-74.627
65000090010,新北市,三峽區,大埔里,691,149,696,650,-5,-501,-0.718,-77.077
65000090011,新北市,三峽區,嘉添里,420,131,441,399,-21,-268,-4.762,-67.168
65000090012,新北市,三峽區,添福里,149,71,143,236,6,-165,4.196,-69.915
65000090013,新北市,三峽區,金圳里,60,24,64,112,-4,-88,-6.25,-78.571
65000090014,新北市,三峽區,五寮里,132,34,104,127,28,-93,26.923,-73.228
65000090015,新北市,三峽區,插角里,87,44,88,191,-1,-147,-1.136,-76.963
65000090016,新北市,三峽區,有木里,77,37,63,153,14,-116,22.222,-75.817
65000090026,新北市,三峽區,二鬮里,676,164,650,551,26,-387,4.0,-70.236
65000090018,新北市,三峽區,溪南里,243,136,232,355,11,-219,4.741,-61.69
65000090017,新北市,三峽區,溪北里,397,151,350,521,47,-370,13.429,-71.017
65000090019,新北市,三峽區,溪東里,486,124,454,532,32,-408,7.048,-76.692
65000090020,新北市,三峽區,成福里,148,92,149,246,-1,-154,-0.671,-62.602
65000090022,新北市,三峽區,竹崙里,289,124,235,405,54,-281,22.979,-69.383
65000090021,新北市,三峽區,安坑里,163,78,151,294,12,-216,7.947,-73.469
65000060031,新北市,新店區,新店里,519,284,369,388,150,-104,40.65,-26.804
65000060032,新北市,新店區,張南里,889,302,650,426,239,-124,36.769,-29.108
65000060033,新北市,新店區,國校里,795,311,564,463,231,-152,40.957,-32.829
65000060034,新北市,新店區,文中里,664,203,475,256,189,-53,39.789,-20.703
65000060035,新北市,新店區,廣明里,252,176,178,231,74,-55,41.573,-23.81
65000060036,新北市,新店區,文明里,801,363,595,535,206,-172,34.622,-32.15
65000060037,新北市,新店區,中興里,2020,644,1549,855,471,-211,30.407,-24.678
65000060038,新北市,新店區,新生里,2065,667,1629,986,436,-319,26.765,-32.353
65000060039,新北市,新店區,新德里,778,353,615,467,163,-114,26.504,-24.411
65000060040,新北市,新店區,張北里,3132,1026,2351,1322,781,-296,33.22,-22.39
65000060041,新北市,新店區,五峯里,2491,943,2057,1281,434,-338,21.099,-26.386
65000060065,新北市,新店區,長春里,896,331,757,463,139,-132,18.362,-28.51
65000060042,新北市,新店區,新安里,1431,465,1141,601,290,-136,25.416,-22.629
65000060043,新北市,新店區,忠誠里,816,306,705,445,111,-139,15.745,-31.236
65000060044,新北市,新店區,中正里,2019,682,1672,945,347,-263,20.754,-27.831
65000060045,新北市,新店區,中華里,1514,469,1282,595,232,-126,18.097,-21.176
65000060046,新北市,新店區,仁愛里,708,252,598,329,110,-77,18.395,-23.404
65000060061,新北市,新店區,建國里,1090,339,930,455,160,-116,17.204,-25.495
65000060047,新北市,新店區,百忍里,1259,443,1069,573,190,-130,17.774,-22.688
65000060048,新北市,新店區,百和里,1098,378,876,533,222,-155,25.342,-29.081
65000060049,新北市,新店區,福德里,1183,396,973,594,210,-198,21.583,-33.333
65000060050,新北市,新店區,百福里,1321,452,1042,639,279,-187,26.775,-29.264
65000060051,新北市,新店區,福民里,1473,393,1319,514,154,-121,11.676,-23.541
65000060052,新北市,新店區,中山里,3788,1128,1565,759,2223,369,142.045,48.617
65000060053,新北市,新店區,和平里,556,156,355,197,201,-41,56.62,-20.812
65000060054,新北市,新店區,中央里,2279,709,1898,974,381,-265,20.074,-27.207
65000060001,新北市,新店區,國豐里,1057,339,916,496,141,-157,15.393,-31.653
65000060002,新北市,新店區,明德里,1274,449,1054,630,220,-181,20.873,-28.73
65000060003,新北市,新店區,大豐里,1205,464,947,650,258,-186,27.244,-28.615
65000060004,新北市,新店區,大同里,1365,489,1096,735,269,-246,24.544,-33.469
65000060005,新北市,新店區,江陵里,1903,627,1571,906,332,-279,21.133,-30.795
65000060062,新北市,新店區,復興里,867,333,704,487,163,-154,23.153,-31.622
65000060006,新北市,新店區,寶興里,1965,674,1550,975,415,-301,26.774,-30.872
65000060058,新北市,新店區,寶福里,2508,793,1978,1236,530,-443,26.795,-35.841
65000060007,新北市,新店區,寶安里,1872,621,1548,909,324,-288,20.93,-31.683
65000060008,新北市,新店區,信義里,2224,854,1731,1258,493,-404,28.481,-32.114
65000060009,新北市,新店區,忠孝里,978,309,715,360,263,-51,36.783,-14.167
65000060010,新北市,新店區,大鵬里,1222,209,1130,275,92,-66,8.142,-24.0
65000060011,新北市,新店區,太平里,1042,372,801,478,241,-106,30.087,-22.176
65000060063,新北市,新店區,美城里,899,329,678,454,221,-125,32.596,-27.533
65000060012,新北市,新店區,頂城里,399,138,330,246,69,-108,20.909,-43.902
65000060013,新北市,新店區,下城里,842,446,640,636,202,-190,31.562,-29.874
65000060014,新北市,新店區,柴埕里,2418,1249,1986,1382,432,-133,21.752,-9.624
65000060056,新北市,新店區,安和里,2394,881,1756,1326,638,-445,36.333,-33.56
65000060015,新北市,新店區,永安里,1457,607,1086,906,371,-299,34.162,-33.002
65000060066,新北市,新店區,新和里,1375,433,1075,580,300,-147,27.907,-25.345
65000060067,新北市,新店區,永平里,1743,658,1265,919,478,-261,37.787,-28.4
65000060016,新北市,新店區,公崙里,4168,1440,2956,2000,1212,-560,41.001,-28.0
65000060064,新北市,新店區,安昌里,1909,646,1360,885,549,-239,40.368,-27.006
65000060017,新北市,新店區,德安里,1734,723,1196,1014,538,-291,44.983,-28.698
65000060068,新北市,新店區,達觀里,1502,393,1174,496,328,-103,27.939,-20.766
65000060055,新北市,新店區,明城里,1216,360,972,497,244,-137,25.103,-27.565
65000060059,新北市,新店區,小城里,1231,410,1080,576,151,-166,13.981,-28.819
65000060018,新北市,新店區,雙城里,1742,734,1160,961,582,-227,50.172,-23.621
65000060060,新北市,新店區,香坡里,4027,1193,2979,1491,1048,-298,35.18,-19.987
65000060019,新北市,新店區,日興里,1518,649,1005,979,513,-330,51.045,-33.708
65000060020,新北市,新店區,玫瑰里,1953,620,1497,871,456,-251,30.461,-28.817
65000060057,新北市,新店區,吉祥里,1699,427,1375,657,324,-230,23.564,-35.008
65000060021,新北市,新店區,塗潭里,168,191,91,287,77,-96,84.615,-33.449
65000060069,新北市,新店區,華城里,954,353,773,528,181,-175,23.415,-33.144
65000060030,新北市,新店區,青潭里,1680,667,1168,892,512,-225,43.836,-25.224
65000060022,新北市,新店區,美潭里,1633,632,1250,831,383,-199,30.64,-23.947
65000060023,新北市,新店區,員潭里,1701,558,1159,803,542,-245,46.764,-30.511
65000060024,新北市,新店區,雙坑里,176,93,96,154,80,-61,83.333,-39.61
65000060025,新北市,新店區,粗坑里,856,522,661,725,195,-203,29.501,-28.0
65000060026,新北市,新店區,屈尺里,600,368,446,500,154,-132,34.529,-26.4
65000060027,新北市,新店區,龜山里,421,214,279,357,142,-143,50.896,-40.056
65000060028,新北市,新店區,廣興里,273,191,185,310,88,-119,47.568,-38.387
65000060029,新北市,新店區,直潭里,333,244,193,317,140,-73,72.539,-23.028
65000180002,新北市,深坑區,萬順里,669,334,461,496,208,-162,45.119,-32.661
65000180007,新北市,深坑區,萬福里,735,384,517,529,218,-145,42.166,-27.41
65000180003,新北市,深坑區,土庫里,837,407,567,576,270,-169,47.619,-29.34
65000180001,新北市,深坑區,深坑里,926,541,637,694,289,-153,45.369,-22.046
65000180006,新北市,深坑區,埔新里,1897,826,1281,1145,616,-319,48.087,-27.86
65000180004,新北市,深坑區,昇高里,664,271,494,408,170,-137,34.413,-33.578
65000180008,新北市,深坑區,賴仲里,742,304,563,402,179,-98,31.794,-24.378
65000180005,新北市,深坑區,阿柔里,155,66,108,128,47,-62,43.519,-48.438
65000190001,新北市,石碇區,石碇里,122,59,59,84,63,-25,106.78,-29.762
65000190002,新北市,石碇區,潭邊里,212,99,148,144,64,-45,43.243,-31.25
65000190004,新北市,石碇區,烏塗里,131,90,83,160,48,-70,57.831,-43.75
65000190005,新北市,石碇區,彭山里,86,44,47,58,39,-14,82.979,-24.138
65000190006,新北市,石碇區,豐田里,85,60,80,104,5,-44,6.25,-42.308
65000190003,新北市,石碇區,隆盛里,140,100,98,139,42,-39,42.857,-28.058
65000190010,新北市,石碇區,豐林里,85,43,51,72,34,-29,66.667,-40.278
65000190008,新北市,石碇區,中民里,173,105,94,155,79,-50,84.043,-32.258
65000190007,新北市,石碇區,永定里,141,56,76,126,65,-70,85.526,-55.556
65000190009,新北市,石碇區,光明里,68,37,33,73,35,-36,106.061,-49.315
65000190011,新北市,石碇區,永安里,170,132,89,225,81,-93,91.011,-41.333
65000190012,新北市,石碇區,格頭里,191,180,138,272,53,-92,38.406,-33.824
65000200002,新北市,坪林區,坪林里,276,154,197,298,79,-144,40.102,-48.322
65000200006,新北市,坪林區,水德里,131,120,84,125,47,-5,55.952,-4.0
65000200003,新北市,坪林區,大林里,195,171,117,323,78,-152,66.667,-47.059
65000200004,新北市,坪林區,石𥕢里,72,40,43,93,29,-53,67.442,-56.989
65000200001,新北市,坪林區,粗窟里,164,107,141,184,23,-77,16.312,-41.848
65000200005,新北市,坪林區,上德里,187,127,111,168,76,-41,68.468,-24.405
65000200007,新北市,坪林區,漁光里,117,118,88,224,29,-106,32.955,-47.321
65000290002,新北市,烏來區,忠治里,387,153,314,217,73,-64,23.248,-29.493
65000290001,新北市,烏來區,烏來里,545,199,450,328,95,-129,21.111,-39.329
65000290005,新北市,烏來區,孝義里,50,29,29,38,21,-9,72.414,-23.684
65000290004,新北市,烏來區,信賢里,96,42,70,86,26,-44,37.143,-51.163
65000290003,新北市,烏來區,福山里,74,26,114,38,-40,-12,-35.088,-31.579
65000270001,新北市,金山區,和平里,72,26,98,90,-26,-64,-26.531,-71.111
65000270002,新北市,金山區,大同里,110,46,117,127,-7,-81,-5.983,-63.78
65000270003,新北市,金山區,豐漁里,80,22,76,117,4,-95,5.263,-81.197
65000270004,新北市,金山區,磺港里,205,63,196,428,9,-365,4.592,-85.28
65000270015,新北市,金山區,金美里,838,267,733,958,105,-691,14.325,-72.129
65000270006,新北市,金山區,五湖里,315,76,280,317,35,-241,12.5,-76.025
65000270005,新北市,金山區,美田里,629,178,602,706,27,-528,4.485,-74.788
65000270007,新北市,金山區,重和里,180,59,148,256,32,-197,21.622,-76.953
65000270008,新北市,金山區,兩湖里,57,24,52,70,5,-46,9.615,-65.714
65000270009,新北市,金山區,六股里,88,39,84,155,4,-116,4.762,-74.839
65000270010,新北市,金山區,三界里,75,31,83,152,-8,-121,-9.639,-79.605
65000270012,新北市,金山區,萬壽里,60,43,55,107,5,-64,9.091,-59.813
65000270011,新北市,金山區,清泉里,113,27,114,136,-1,-109,-0.877,-80.147
65000270013,新北市,金山區,西湖里,21,13,31,40,-10,-27,-32.258,-67.5
65000270014,新北市,金山區,永興里,43,21,63,116,-20,-95,-31.746,-81.897
65000280001,新北市,萬里區,萬里里,634,197,695,778,-61,-581,-8.777,-74.679
65000280010,新北市,萬里區,北基里,466,128,494,430,-28,-302,-5.668,-70.233
65000280002,新北市,萬里區,龜吼里,351,109,370,397,-19,-288,-5.135,-72.544
65000280003,新北市,萬里區,野柳里,454,113,461,561,-7,-448,-1.518,-79.857
65000280004,新北市,萬里區,大鵬里,393,120,441,509,-48,-389,-10.884,-76.424
65000280005,新北市,萬里區,磺潭里,98,21,92,92,6,-71,6.522,-77.174
65000280006,新北市,萬里區,雙興里,157,34,125,198,32,-164,25.6,-82.828
65000280007,新北市,萬里區,溪底里,56,31,65,134,-9,-103,-13.846,-76.866
65000280008,新北市,萬里區,崁脚里,44,13,45,101,-1,-88,-2.222,-87.129
65000280009,新北市,萬里區,中幅里,123,47,172,184,-49,-137,-28.488,-74.457
65000110028,新北市,汐止區,仁德里,371,130,375,358,-4,-228,-1.067,-63.687
65000110001,新北市,汐止區,義民里,212,62,264,264,-52,-202,-19.697,-76.515
65000110002,新北市,汐止區,禮門里,196,64,194,255,2,-191,1.031,-74.902
65000110003,新北市,汐止區,智慧里,1029,221,1049,820,-20,-599,-1.907,-73.049
65000110041,新北市,汐止區,大同里,565,165,575,513,-10,-348,-1.739,-67.836
65000110004,新北市,汐止區,信望里,64,16,68,77,-4,-61,-5.882,-79.221
65000110007,新北市,汐止區,新昌里,928,287,943,1008,-15,-721,-1.591,-71.528
65000110045,新北市,汐止區,福安里,1177,317,1140,1123,37,-806,3.246,-71.772
65000110006,新北市,汐止區,秀峰里,738,194,668,739,70,-545,10.479,-73.748
65000110046,新北市,汐止區,秀山里,976,208,889,782,87,-574,9.786,-73.402
65000110008,新北市,汐止區,復興里,1824,496,1699,1459,125,-963,7.357,-66.004
65000110031,新北市,汐止區,自強里,1131,297,1078,1068,53,-771,4.917,-72.191
65000110032,新北市,汐止區,文化里,1048,263,870,858,178,-595,20.46,-69.347
65000110021,新北市,汐止區,白雲里,909,257,806,797,103,-540,12.779,-67.754
65000110009,新北市,汐止區,茄苳里,902,255,661,718,241,-463,36.46,-64.485
65000110042,新北市,汐止區,崇德里,956,300,969,953,-13,-653,-1.342,-68.52
65000110048,新北市,汐止區,城中里,1081,285,1036,812,45,-527,4.344,-64.901
65000110005,新北市,汐止區,橋東里,812,205,610,633,202,-428,33.115,-67.615
65000110047,新北市,汐止區,建成里,1322,338,1191,924,131,-586,10.999,-63.42
65000110010,新北市,汐止區,長安里,301,96,291,340,10,-244,3.436,-71.765
65000110011,新北市,汐止區,保安里,247,88,256,288,-9,-200,-3.516,-69.444
65000110023,新北市,汐止區,東山里,78,43,101,115,-23,-72,-22.772,-62.609
65000110012,新北市,汐止區,保長里,932,280,789,876,143,-596,18.124,-68.037
65000110050,新北市,汐止區,保新里,649,131,587,446,62,-315,10.562,-70.628
65000110013,新北市,汐止區,鄉長里,477,165,427,506,50,-341,11.71,-67.391
65000110014,新北市,汐止區,江北里,1133,341,1035,1077,98,-736,9.469,-68.338
65000110015,新北市,汐止區,拱北里,901,246,828,769,73,-523,8.816,-68.01
65000110016,新北市,汐止區,烘內里,312,114,312,314,0,-200,0.0,-63.694
65000110017,新北市,汐止區,八連里,164,75,139,200,25,-125,17.986,-62.5
65000110044,新北市,汐止區,長青里,235,83,248,204,-13,-121,-5.242,-59.314
65000110019,新北市,汐止區,北峰里,866,283,756,966,110,-683,14.55,-70.704
65000110033,新北市,汐止區,金龍里,1135,320,976,955,159,-635,16.291,-66.492
65000110018,新北市,汐止區,樟樹里,383,121,350,414,33,-293,9.429,-70.773
65000110030,新北市,汐止區,忠孝里,1767,422,1549,1387,218,-965,14.074,-69.575
65000110029,新北市,汐止區,厚德里,1419,326,1326,1117,93,-791,7.014,-70.815
65000110040,新北市,汐止區,山光里,695,116,524,370,171,-254,32.634,-68.649
65000110026,新北市,汐止區,中興里,1450,352,1289,1434,161,-1082,12.49,-75.453
65000110034,新北市,汐止區,福德里,692,187,545,588,147,-401,26.972,-68.197
65000110035,新北市,汐止區,興福里,769,219,674,599,95,-380,14.095,-63.439
65000110036,新北市,汐止區,康福里,1147,305,962,901,185,-596,19.231,-66.149
65000110027,新北市,汐止區,湖光里,1482,357,1382,1090,100,-733,7.236,-67.248
65000110049,新北市,汐止區,湖蓮里,870,207,831,520,39,-313,4.693,-60.192
65000110043,新北市,汐止區,湖興里,1651,329,1631,1114,20,-785,1.226,-70.467
65000110020,新北市,汐止區,北山里,1314,400,1236,1178,78,-778,6.311,-66.044
65000110037,新北市,汐止區,忠山里,962,197,985,644,-23,-447,-2.335,-69.41
65000110038,新北市,汐止區,環河里,179,96,194,319,-15,-223,-7.732,-69.906
65000110022,新北市,汐止區,橫科里,902,230,943,884,-41,-654,-4.348,-73.982
65000110024,新北市,汐止區,福山里,780,210,817,729,-37,-519,-4.529,-71.193
65000110025,新北市,汐止區,宜興里,739,177,783,545,-44,-368,-5.619,-67.523
65000110039,新北市,汐止區,東勢里,1235,280,1164,908,71,-628,6.1,-69.163
65000240001,新北市,平溪區,薯榔里,38,24,46,86,-8,-62,-17.391,-72.093
65000240002,新北市,平溪區,菁桐里,40,13,49,36,-9,-23,-18.367,-63.889
65000240003,新北市,平溪區,白石里,43,15,35,61,8,-46,22.857,-75.41
65000240004,新北市,平溪區,石底里,55,38,50,110,5,-72,10.0,-65.455
65000240005,新北市,平溪區,平溪里,49,3,60,41,-11,-38,-18.333,-92.683
65000240006,新北市,平溪區,嶺腳里,79,13,82,95,-3,-82,-3.659,-86.316
65000240007,新北市,平溪區,東勢里,67,18,66,90,1,-72,1.515,-80.0
65000240011,新北市,平溪區,十分里,102,32,121,133,-19,-101,-15.702,-75.94
65000240008,新北市,平溪區,望古里,26,7,24,34,2,-27,8.333,-79.412
65000240009,新北市,平溪區,南山里,52,22,54,65,-2,-43,-3.704,-66.154
65000240012,新北市,平溪區,新寮里,19,3,18,21,1,-18,5.556,-85.714
65000240010,新北市,平溪區,平湖里,15,11,32,40,-17,-29,-53.125,-72.5
65000120001,新北市,瑞芳區,龍潭里,152,42,139,164,13,-122,9.353,-74.39
65000120002,新北市,瑞芳區,龍興里,394,100,385,399,9,-299,2.338,-74.937
65000120003,新北市,瑞芳區,龍鎮里,234,58,230,235,4,-177,1.739,-75.319
65000120006,新北市,瑞芳區,龍安里,139,28,112,105,27,-77,24.107,-73.333
65000120004,新北市,瑞芳區,龍川里,302,73,279,313,23,-240,8.244,-76.677
65000120005,新北市,瑞芳區,龍山里,251,42,266,216,-15,-174,-5.639,-80.556
65000120007,新北市,瑞芳區,爪峯里,589,171,554,740,35,-569,6.318,-76.892
65000120034,新北市,瑞芳區,新峰里,546,126,444,463,102,-337,22.973,-72.786
65000120009,新北市,瑞芳區,東和里,274,76,263,302,11,-226,4.183,-74.834
65000120008,新北市,瑞芳區,柑坪里,129,60,144,223,-15,-163,-10.417,-73.094
65000120016,新北市,瑞芳區,弓橋里,46,20,37,79,9,-59,24.324,-74.684
65000120014,新北市,瑞芳區,猴硐里,41,20,53,89,-12,-69,-22.642,-77.528
65000120015,新北市,瑞芳區,光復里,38,16,35,56,3,-40,8.571,-71.429
65000120017,新北市,瑞芳區,碩仁里,24,11,34,38,-10,-27,-29.412,-71.053
65000120011,新北市,瑞芳區,吉慶里,342,89,291,267,51,-178,17.526,-66.667
65000120012,新北市,瑞芳區,吉安里,518,135,476,502,42,-367,8.824,-73.108
65000120010,新北市,瑞芳區,上天里,211,40,225,244,-14,-204,-6.222,-83.607
65000120013,新北市,瑞芳區,傑魚里,295,84,280,383,15,-299,5.357,-78.068
65000120018,新北市,瑞芳區,基山里,52,35,77,103,-25,-68,-32.468,-66.019
65000120019,新北市,瑞芳區,永慶里,52,22,60,68,-8,-46,-13.333,-67.647
65000120020,新北市,瑞芳區,崇文里,48,24,46,68,2,-44,4.348,-64.706
65000120021,新北市,瑞芳區,福住里,45,13,38,31,7,-18,18.421,-58.065
65000120022,新北市,瑞芳區,頌德里,60,15,61,58,-1,-43,-1.639,-74.138
65000120024,新北市,瑞芳區,瓜山里,42,6,42,30,0,-24,0.0,-80.0
65000120025,新北市,瑞芳區,銅山里,30,6,33,47,-3,-41,-9.091,-87.234
65000120023,新北市,瑞芳區,新山里,66,19,53,54,13,-35,24.528,-64.815
65000120026,新北市,瑞芳區,石山里,57,12,63,47,-6,-35,-9.524,-74.468
65000120028,新北市,瑞芳區,濓洞里,75,26,96,71,-21,-45,-21.875,-63.38
65000120027,新北市,瑞芳區,濓新里,33,8,35,44,-2,-36,-5.714,-81.818
65000120032,新北市,瑞芳區,南雅里,48,22,46,73,2,-51,4.348,-69.863
65000120033,新北市,瑞芳區,鼻頭里,83,22,92,173,-9,-151,-9.783,-87.283
65000120029,新北市,瑞芳區,海濱里,184,30,188,147,-4,-117,-2.128,-79.592
65000120030,新北市,瑞芳區,瑞濱里,290,88,284,306,6,-218,2.113,-71.242
65000120031,新北市,瑞芳區,深澳里,189,40,202,164,-13,-124,-6.436,-75.61
65000250001,新北市,雙溪區,雙溪里,68,23,87,88,-19,-65,-21.839,-73.864
65000250003,新北市,雙溪區,新基里,149,43,145,151,4,-108,2.759,-71.523
65000250005,新北市,雙溪區,三港里,47,15,41,82,6,-67,14.634,-81.707
65000250006,新北市,雙溪區,牡丹里,190,48,207,284,-17,-236,-8.213,-83.099
65000250007,新北市,雙溪區,三貂里,44,35,45,62,-1,-27,-2.222,-43.548
65000250008,新北市,雙溪區,平林里,135,42,160,171,-25,-129,-15.625,-75.439
65000250009,新北市,雙溪區,上林里,87,28,64,143,23,-115,35.938,-80.42
65000250010,新北市,雙溪區,外柑里,67,15,77,85,-10,-70,-12.987,-82.353
65000250011,新北市,雙溪區,長源里,24,23,28,81,-4,-58,-14.286,-71.605
65000250002,新北市,雙溪區,共和里,59,17,57,77,2,-60,3.509,-77.922
65000250004,新北市,雙溪區,魚行里,100,48,90,141,10,-93,11.111,-65.957
65000250012,新北市,雙溪區,泰平里,115,48,139,190,-24,-142,-17.266,-74.737
65000260001,新北市,貢寮區,貢寮里,93,37,116,200,-23,-163,-19.828,-81.5
65000260004,新北市,貢寮區,龍崗里,28,21,39,106,-11,-85,-28.205,-80.189
65000260002,新北市,貢寮區,吉林里,35,21,49,109,-14,-88,-28.571,-80.734
65000260003,新北市,貢寮區,雙玉里,58,47,59,183,-1,-136,-1.695,-74.317
65000260009,新北市,貢寮區,福連里,118,60,80,240,38,-180,47.5,-75.0
65000260006,新北市,貢寮區,福隆里,140,91,167,417,-27,-326,-16.168,-78.177
65000260005,新北市,貢寮區,龍門里,49,63,49,235,0,-172,0.0,-73.191
65000260008,新北市,貢寮區,真理里,95,151,114,620,-19,-469,-16.667,-75.645
65000260007,新北市,貢寮區,仁里里,146,110,190,543,-44,-433,-23.158,-79.742
65000260010,新北市,貢寮區,美豐里,49,45,69,223,-20,-178,-28.986,-79.821
65000260011,新北市,貢寮區,和美里,59,51,75,263,-16,-212,-21.333,-80.608
10009130002,雲林縣,麥寮鄉,麥豐村,1347,226,1018,916,329,-690,32.318,-75.328
10009130001,雲林縣,麥寮鄉,麥津村,722,125,580,543,142,-418,24.483,-76.98
10009130003,雲林縣,麥寮鄉,瓦磘村,212,62,191,326,21,-264,10.995,-80.982
10009130004,雲林縣,麥寮鄉,興華村,437,68,307,445,130,-377,42.345,-84.719
10009130007,雲林縣,麥寮鄉,海豐村,373,48,245,261,128,-213,52.245,-81.609
10009130006,雲林縣,麥寮鄉,後安村,494,61,383,278,111,-217,28.982,-78.058
10009130013,雲林縣,麥寮鄉,中興村,247,44,180,189,67,-145,37.222,-76.72
10009130008,雲林縣,麥寮鄉,三盛村,291,61,215,302,76,-241,35.349,-79.801
10009130005,雲林縣,麥寮鄉,崙後村,383,74,343,291,40,-217,11.662,-74.57
10009130009,雲林縣,麥寮鄉,橋頭村,571,115,462,541,109,-426,23.593,-78.743
10009130010,雲林縣,麥寮鄉,新吉村,183,36,129,173,54,-137,41.86,-79.191
10009130011,雲林縣,麥寮鄉,施厝村,527,122,385,543,142,-421,36.883,-77.532
10009130012,雲林縣,麥寮鄉,雷厝村,277,57,262,282,15,-225,5.725,-79.787
10009160001,雲林縣,臺西鄉,台西村,244,39,239,176,5,-137,2.092,-77.841
10009160003,雲林縣,臺西鄉,海南村,175,48,165,146,10,-98,6.061,-67.123
10009160002,雲林縣,臺西鄉,海北村,156,35,173,147,-17,-112,-9.827,-76.19
10009160004,雲林縣,臺西鄉,海口村,310,38,274,218,36,-180,13.139,-82.569
10009160010,雲林縣,臺西鄉,山寮村,119,28,125,86,-6,-58,-4.8,-67.442
10009160005,雲林縣,臺西鄉,溪頂村,187,47,159,202,28,-155,17.61,-76.733
10009160006,雲林縣,臺西鄉,牛厝村,209,39,192,260,17,-221,8.854,-85.0
10009160007,雲林縣,臺西鄉,泉州村,107,34,72,85,35,-51,48.611,-60.0
10009160009,雲林縣,臺西鄉,五榔村,46,11,37,103,9,-92,24.324,-89.32
10009160008,雲林縣,臺西鄉,光華村,118,34,104,116,14,-82,13.462,-70.69
10009160015,雲林縣,臺西鄉,五港村,281,53,240,220,41,-167,17.083,-75.909
10009160011,雲林縣,臺西鄉,富琦村,236,34,194,187,42,-153,21.649,-81.818
10009160012,雲林縣,臺西鄉,永豐村,205,36,179,191,26,-155,14.525,-81.152
10009160013,雲林縣,臺西鄉,和豐村,363,62,358,408,5,-346,1.397,-84.804
10009160014,雲林縣,臺西鄉,蚊港村,289,38,246,189,43,-151,17.48,-79.894
10009140005,雲林縣,東勢鄉,月眉村,137,36,118,223,19,-187,16.102,-83.857
10009140004,雲林縣,東勢鄉,復興村,75,15,90,109,-15,-94,-16.667,-86.239
10009140003,雲林縣,東勢鄉,嘉隆村,167,63,180,257,-13,-194,-7.222,-75.486
10009140001,雲林縣,東勢鄉,東南村,282,50,290,267,-8,-217,-2.759,-81.273
10009140002,雲林縣,東勢鄉,東北村,208,34,181,202,27,-168,14.917,-83.168
10009140007,雲林縣,東勢鄉,龍潭村,87,38,74,192,13,-154,17.568,-80.208
10009140006,雲林縣,東勢鄉,程海村,83,24,77,104,6,-80,7.792,-76.923
10009140009,雲林縣,東勢鄉,昌南村,144,27,116,162,28,-135,24.138,-83.333
10009140008,雲林縣,東勢鄉,安南村,84,26,86,125,-2,-99,-2.326,-79.2
10009140010,雲林縣,東勢鄉,同安村,259,50,265,290,-6,-240,-2.264,-82.759
10009140012,雲林縣,東勢鄉,四美村,129,31,130,160,-1,-129,-0.769,-80.625
10009140011,雲林縣,東勢鄉,新坤村,134,19,141,172,-7,-153,-4.965,-88.953
10009150001,雲林縣,褒忠鄉,中民村,349,88,297,407,52,-319,17.508,-78.378
10009150002,雲林縣,褒忠鄉,埔姜村,254,57,234,291,20,-234,8.547,-80.412
10009150003,雲林縣,褒忠鄉,中勝村,236,67,212,305,24,-238,11.321,-78.033
10009150005,雲林縣,褒忠鄉,馬鳴村,224,49,183,322,41,-273,22.404,-84.783
10009150004,雲林縣,褒忠鄉,新湖村,165,52,142,290,23,-238,16.197,-82.069
10009150006,雲林縣,褒忠鄉,有才村,92,26,107,188,-15,-162,-14.019,-86.17
10009150007,雲林縣,褒忠鄉,田洋村,123,30,112,170,11,-140,9.821,-82.353
10009150008,雲林縣,褒忠鄉,龍岩村,171,43,175,215,-4,-172,-2.286,-80.0
10009150009,雲林縣,褒忠鄉,潮厝村,114,41,119,188,-5,-147,-4.202,-78.191
10009050001,雲林縣,土庫鎮,忠正里,127,49,136,181,-9,-132,-6.618,-72.928
10009050002,雲林縣,土庫鎮,順天里,162,57,130,198,32,-141,24.615,-71.212
10009050003,雲林縣,土庫鎮,宮北里,266,81,262,304,4,-223,1.527,-73.355
10009050004,雲林縣,土庫鎮,越港里,269,77,222,226,47,-149,21.171,-65.929
10009050005,雲林縣,土庫鎮,溪邊里,172,50,132,206,40,-156,30.303,-75.728
10009050010,雲林縣,土庫鎮,石廟里,576,142,400,512,176,-370,44.0,-72.266
10009050006,雲林縣,土庫鎮,興新里,245,74,188,309,57,-235,30.319,-76.052
10009050007,雲林縣,土庫鎮,奮起里,182,45,165,235,17,-190,10.303,-80.851
10009050008,雲林縣,土庫鎮,埤腳里,168,50,177,245,-9,-195,-5.085,-79.592
10009050015,雲林縣,土庫鎮,後埔里,295,61,261,419,34,-358,13.027,-85.442
10009050016,雲林縣,土庫鎮,崙內里,204,48,171,269,33,-221,19.298,-82.156
10009050009,雲林縣,土庫鎮,大荖里,122,35,116,194,6,-159,5.172,-81.959
10009050011,雲林縣,土庫鎮,東平里,235,85,201,437,34,-352,16.915,-80.549
10009050012,雲林縣,土庫鎮,南平里,265,69,249,364,16,-295,6.426,-81.044
10009050014,雲林縣,土庫鎮,西平里,237,65,196,379,41,-314,20.918,-82.85
10009050013,雲林縣,土庫鎮,北平里,106,42,93,190,13,-148,13.978,-77.895
10009050017,雲林縣,土庫鎮,新庄里,190,67,166,291,24,-224,14.458,-76.976
10009030003,雲林縣,虎尾鎮,東仁里,574,136,516,504,58,-368,11.24,-73.016
10009030002,雲林縣,虎尾鎮,新興里,329,85,331,315,-2,-230,-0.604,-73.016
10009030004,雲林縣,虎尾鎮,公安里,636,146,593,590,43,-444,7.251,-75.254
10009030005,雲林縣,虎尾鎮,德興里,551,120,511,426,40,-306,7.828,-71.831
10009030001,雲林縣,虎尾鎮,中山里,162,50,172,194,-10,-144,-5.814,-74.227
10009030006,雲林縣,虎尾鎮,西安里,690,135,638,554,52,-419,8.15,-75.632
10009030028,雲林縣,虎尾鎮,立仁里,855,163,762,634,93,-471,12.205,-74.29
10009030007,雲林縣,虎尾鎮,安慶里,314,78,325,287,-11,-209,-3.385,-72.822
10009030008,雲林縣,虎尾鎮,平和里,1055,221,847,775,208,-554,24.557,-71.484
10009030009,雲林縣,虎尾鎮,興南里,487,97,434,436,53,-339,12.212,-77.752
10009030010,雲林縣,虎尾鎮,新吉里,769,216,681,762,88,-546,12.922,-71.654
10009030011,雲林縣,虎尾鎮,穎川里,450,106,387,389,63,-283,16.279,-72.751
10009030012,雲林縣,虎尾鎮,延平里,221,32,208,210,13,-178,6.25,-84.762
10009030027,雲林縣,虎尾鎮,建國里,101,21,96,69,5,-48,5.208,-69.565
10009030018,雲林縣,虎尾鎮,埒內里,480,153,364,568,116,-415,31.868,-73.063
10009030019,雲林縣,虎尾鎮,堀頭里,203,45,156,141,47,-96,30.128,-68.085
10009030020,雲林縣,虎尾鎮,安溪里,284,67,227,349,57,-282,25.11,-80.802
10009030021,雲林縣,虎尾鎮,興中里,358,79,264,320,94,-241,35.606,-75.312
10009030022,雲林縣,虎尾鎮,廉使里,706,225,467,728,239,-503,51.178,-69.093
10009030023,雲林縣,虎尾鎮,惠來里,397,118,320,437,77,-319,24.062,-72.998
10009030024,雲林縣,虎尾鎮,頂溪里,434,93,320,505,114,-412,35.625,-81.584
10009030025,雲林縣,虎尾鎮,中溪里,229,71,197,287,32,-216,16.244,-75.261
10009030026,雲林縣,虎尾鎮,下溪里,354,87,256,293,98,-206,38.281,-70.307
10009030029,雲林縣,虎尾鎮,東屯里,198,27,167,211,31,-184,18.563,-87.204
10009030016,雲林縣,虎尾鎮,西屯里,230,57,200,306,30,-249,15.0,-81.373
10009030017,雲林縣,虎尾鎮,芳草里,96,35,73,190,23,-155,31.507,-81.579
10009030015,雲林縣,虎尾鎮,墾地里,453,100,222,362,231,-262,104.054,-72.376
10009030014,雲林縣,虎尾鎮,北溪里,180,32,147,151,33,-119,22.449,-78.808
10009030013,雲林縣,虎尾鎮,三合里,265,55,238,239,27,-184,11.345,-76.987
10009180001,雲林縣,四湖鄉,四湖村,270,56,265,319,5,-263,1.887,-82.445
10009180005,雲林縣,四湖鄉,湖西村,454,78,389,361,65,-283,16.71,-78.393
10009180002,雲林縣,四湖鄉,新庄村,74,28,67,118,7,-90,10.448,-76.271
10009180003,雲林縣,四湖鄉,溪底村,116,28,105,154,11,-126,10.476,-81.818
10009180004,雲林縣,四湖鄉,鹿場村,111,28,89,169,22,-141,24.719,-83.432
10009180008,雲林縣,四湖鄉,蔡厝村,69,15,91,119,-22,-104,-24.176,-87.395
10009180007,雲林縣,四湖鄉,湖寮村,68,23,75,113,-7,-90,-9.333,-79.646
10009180006,雲林縣,四湖鄉,施湖村,154,31,138,156,16,-125,11.594,-80.128
10009180012,雲林縣,四湖鄉,羊調村,107,20,99,122,8,-102,8.081,-83.607
10009180011,雲林縣,四湖鄉,內湖村,75,20,56,130,19,-110,33.929,-84.615
10009180020,雲林縣,四湖鄉,飛東村,47,30,50,108,-3,-78,-6.0,-72.222
10009180009,雲林縣,四湖鄉,飛沙村,108,31,103,124,5,-93,4.854,-75.0
10009180010,雲林縣,四湖鄉,三姓村,39,10,32,53,7,-43,21.875,-81.132
10009180013,雲林縣,四湖鄉,崙北村,164,19,159,222,5,-203,3.145,-91.441
10009180014,雲林縣,四湖鄉,崙南村,97,14,82,95,15,-81,18.293,-85.263
10009180015,雲林縣,四湖鄉,廣溝村,81,25,65,71,16,-46,24.615,-64.789
10009180016,雲林縣,四湖鄉,萡子村,62,39,72,170,-10,-131,-13.889,-77.059
10009180021,雲林縣,四湖鄉,萡東村,72,58,56,216,16,-158,28.571,-73.148
10009180017,雲林縣,四湖鄉,林厝村,96,32,102,178,-6,-146,-5.882,-82.022
10009180018,雲林縣,四湖鄉,林東村,85,24,97,117,-12,-93,-12.371,-79.487
10009180019,雲林縣,四湖鄉,溪尾村,101,22,86,79,15,-57,17.442,-72.152
10009170001,雲林縣,元長鄉,長南村,473,139,382,643,91,-504,23.822,-78.383
10009170002,雲林縣,元長鄉,長北村,206,57,166,324,40,-267,24.096,-82.407
10009170003,雲林縣,元長鄉,子茂村,181,35,139,269,42,-234,30.216,-86.989
10009170004,雲林縣,元長鄉,後湖村,84,41,78,151,6,-110,7.692,-72.848
10009170005,雲林縣,元長鄉,山內村,150,33,116,173,34,-140,29.31,-80.925
10009170006,雲林縣,元長鄉,合和村,120,47,97,200,23,-153,23.711,-76.5
10009170007,雲林縣,元長鄉,五塊村,134,20,140,145,-6,-125,-4.286,-86.207
10009170008,雲林縣,元長鄉,潭西村,68,45,61,197,7,-152,11.475,-77.157
10009170009,雲林縣,元長鄉,潭東村,102,22,85,91,17,-69,20.0,-75.824
10009170010,雲林縣,元長鄉,客厝村,108,31,105,115,3,-84,2.857,-73.043
10009170011,雲林縣,元長鄉,卓運村,46,18,27,110,19,-92,70.37,-83.636
10009170012,雲林縣,元長鄉,頂寮村,128,34,94,201,34,-167,36.17,-83.085
10009170013,雲林縣,元長鄉,下寮村,202,42,167,269,35,-227,20.958,-84.387
10009170014,雲林縣,元長鄉,龍岩村,91,40,76,238,15,-198,19.737,-83.193
10009170015,雲林縣,元長鄉,西莊村,134,35,87,162,47,-127,54.023,-78.395
10009170016,雲林縣,元長鄉,鹿北村,126,42,157,154,-31,-112,-19.745,-72.727
10009170017,雲林縣,元長鄉,鹿南村,124,27,99,166,25,-139,25.253,-83.735
10009170018,雲林縣,元長鄉,瓦磘村,141,66,132,281,9,-215,6.818,-76.512
10009170019,雲林縣,元長鄉,內寮村,57,22,51,121,6,-99,11.765,-81.818
10009170020,雲林縣,元長鄉,崙仔村,86,26,83,115,3,-89,3.614,-77.391
10009170021,雲林縣,元長鄉,新吉村,120,18,95,132,25,-114,26.316,-86.364
10009190002,雲林縣,口湖鄉,口湖村,173,41,149,201,24,-160,16.107,-79.602
10009190001,雲林縣,口湖鄉,湖東村,214,39,160,219,54,-180,33.75,-82.192
10009190003,雲林縣,口湖鄉,頂湖村,71,20,72,95,-1,-75,-1.389,-78.947
10009190005,雲林縣,口湖鄉,埔南村,112,36,76,176,36,-140,47.368,-79.545
10009190004,雲林縣,口湖鄉,埔北村,97,27,75,186,22,-159,29.333,-85.484
10009190006,雲林縣,口湖鄉,謝厝村,147,62,83,263,64,-201,77.108,-76.426
10009190007,雲林縣,口湖鄉,蚵寮村,141,69,98,303,43,-234,43.878,-77.228
10009190008,雲林縣,口湖鄉,下崙村,182,51,174,370,8,-319,4.598,-86.216
10009190009,雲林縣,口湖鄉,崙中村,171,69,126,276,45,-207,35.714,-75.0
10009190010,雲林縣,口湖鄉,崙東村,200,48,144,253,56,-205,38.889,-81.028
10009190011,雲林縣,口湖鄉,青蚶村,31,23,34,108,-3,-85,-8.824,-78.704
10009190012,雲林縣,口湖鄉,港東村,183,35,149,278,34,-243,22.819,-87.41
10009190013,雲林縣,口湖鄉,港西村,120,34,87,166,33,-132,37.931,-79.518
10009190014,雲林縣,口湖鄉,台子村,148,104,85,550,63,-446,74.118,-81.091
10009190015,雲林縣,口湖鄉,成龍村,105,34,102,181,3,-147,2.941,-81.215
10009190019,雲林縣,口湖鄉,梧南村,221,77,190,470,31,-393,16.316,-83.617
10009190020,雲林縣,口湖鄉,梧北村,141,80,99,383,42,-303,42.424,-79.112
10009190017,雲林縣,口湖鄉,水井村,147,43,124,201,23,-158,18.548,-78.607
10009190018,雲林縣,口湖鄉,後厝村,66,27,74,157,-8,-130,-10.811,-82.803
10009190016,雲林縣,口湖鄉,湖口村,99,33,71,227,28,-194,39.437,-85.463
10009190021,雲林縣,口湖鄉,過港村,73,39,64,116,9,-77,14.062,-66.379
10009200001,雲林縣,水林鄉,水北村,267,88,219,430,48,-342,21.918,-79.535
10009200002,雲林縣,水林鄉,水南村,283,113,237,483,46,-370,19.409,-76.605
10009200011,雲林縣,水林鄉,萬興村,81,32,52,160,29,-128,55.769,-80.0
10009200012,雲林縣,水林鄉,尖山村,69,25,49,153,20,-128,40.816,-83.66
10009200014,雲林縣,水林鄉,大溝村,72,43,93,249,-21,-206,-22.581,-82.731
10009200015,雲林縣,水林鄉,順興村,67,39,69,196,-2,-157,-2.899,-80.102
10009200013,雲林縣,水林鄉,大山村,84,57,94,268,-10,-211,-10.638,-78.731
10009200023,雲林縣,水林鄉,後寮村,70,21,71,155,-1,-134,-1.408,-86.452
10009200005,雲林縣,水林鄉,春埔村,103,55,93,225,10,-170,10.753,-75.556
10009200006,雲林縣,水林鄉,西井村,89,35,84,112,5,-77,5.952,-68.75
10009200007,雲林縣,水林鄉,車港村,55,33,63,119,-8,-86,-12.698,-72.269
10009200008,雲林縣,水林鄉,蘇秦村,96,49,75,225,21,-176,28.0,-78.222
10009200009,雲林縣,水林鄉,灣東村,81,30,78,97,3,-67,3.846,-69.072
10009200010,雲林縣,水林鄉,灣西村,100,40,109,178,-9,-138,-8.257,-77.528
10009200016,雲林縣,水林鄉,蕃薯村,85,46,89,232,-4,-186,-4.494,-80.172
10009200017,雲林縣,水林鄉,山腳村,59,38,59,187,0,-149,0.0,-79.679
10009200018,雲林縣,水林鄉,松北村,106,34,113,177,-7,-143,-6.195,-80.791
10009200019,雲林縣,水林鄉,松中村,48,40,40,145,8,-105,20.0,-72.414
10009200020,雲林縣,水林鄉,松西村,44,36,38,158,6,-122,15.789,-77.215
10009200021,雲林縣,水林鄉,瓊埔村,77,50,38,187,39,-137,102.632,-73.262
10009200022,雲林縣,水林鄉,塭底村,45,53,37,153,8,-100,21.622,-65.359
10009200003,雲林縣,水林鄉,海埔村,82,43,84,270,-2,-227,-2.381,-84.074
10009200004,雲林縣,水林鄉,土厝村,112,57,87,316,25,-259,28.736,-81.962
10009200024,雲林縣,水林鄉,溪墘村,106,27,84,163,22,-136,26.19,-83.436
10009060001,雲林縣,北港鎮,東陽里,116,70,108,200,8,-130,7.407,-65.0
10009060002,雲林縣,北港鎮,光民里,116,69,78,200,38,-131,48.718,-65.5
10009060003,雲林縣,北港鎮,東華里,86,31,76,104,10,-73,13.158,-70.192
10009060004,雲林縣,北港鎮,南安里,135,62,135,239,0,-177,0.0,-74.059
10009060005,雲林縣,北港鎮,中和里,38,22,48,99,-10,-77,-20.833,-77.778
10009060006,雲林縣,北港鎮,義民里,70,23,63,94,7,-71,11.111,-75.532
10009060007,雲林縣,北港鎮,共榮里,60,23,40,112,20,-89,50.0,-79.464
10009060008,雲林縣,北港鎮,西勢里,178,51,136,228,42,-177,30.882,-77.632
10009060009,雲林縣,北港鎮,仁和里,83,35,76,124,7,-89,9.211,-71.774
10009060010,雲林縣,北港鎮,賜福里,57,29,58,84,-1,-55,-1.724,-65.476
10009060011,雲林縣,北港鎮,公舘里,105,42,79,123,26,-81,32.911,-65.854
10009060012,雲林縣,北港鎮,大同里,215,90,154,281,61,-191,39.61,-67.972
10009060013,雲林縣,北港鎮,仁安里,93,33,87,117,6,-84,6.897,-71.795
10009060014,雲林縣,北港鎮,華勝里,889,324,740,1175,149,-851,20.135,-72.426
10009060015,雲林縣,北港鎮,光復里,313,93,294,336,19,-243,6.463,-72.321
10009060026,雲林縣,北港鎮,扶朝里,65,99,68,351,-3,-252,-4.412,-71.795
10009060027,雲林縣,北港鎮,水埔里,52,36,41,112,11,-76,26.829,-67.857
10009060016,雲林縣,北港鎮,新街里,1191,406,1014,1346,177,-940,17.456,-69.837
10009060017,雲林縣,北港鎮,劉厝里,155,69,108,289,47,-220,43.519,-76.125
10009060021,雲林縣,北港鎮,後溝里,144,57,96,241,48,-184,50.0,-76.349
10009060028,雲林縣,北港鎮,新厝里,67,17,40,91,27,-74,67.5,-81.319
10009060018,雲林縣,北港鎮,府番里,117,22,106,126,11,-104,10.377,-82.54
10009060019,雲林縣,北港鎮,草湖里,109,76,104,292,5,-216,4.808,-73.973
10009060020,雲林縣,北港鎮,溝皂里,147,60,120,261,27,-201,22.5,-77.011
10009060022,雲林縣,北港鎮,番溝里,77,63,67,164,10,-101,14.925,-61.585
10009060023,雲林縣,北港鎮,大北里,52,34,38,132,14,-98,36.842,-74.242
10009060024,雲林縣,北港鎮,好收里,175,74,180,355,-5,-281,-2.778,-79.155
10009060025,雲林縣,北港鎮,樹腳里,442,192,387,719,55,-527,14.212,-73.296
10009120001,雲林縣,崙背鄉,東明村,207,59,176,244,31,-185,17.614,-75.82
10009120002,雲林縣,崙背鄉,西榮村,194,96,220,286,-26,-190,-11.818,-66.434
10009120003,雲林縣,崙背鄉,南陽村,416,145,379,453,37,-308,9.763,-67.991
10009120004,雲林縣,崙背鄉,崙前村,270,132,230,501,40,-369,17.391,-73.653
10009120005,雲林縣,崙背鄉,羅厝村,272,137,251,489,21,-352,8.367,-71.984
10009120006,雲林縣,崙背鄉,港尾村,166,63,114,309,52,-246,45.614,-79.612
10009120007,雲林縣,崙背鄉,阿勸村,299,56,256,337,43,-281,16.797,-83.383
10009120008,雲林縣,崙背鄉,五魁村,171,29,171,88,0,-59,0.0,-67.045
10009120009,雲林縣,崙背鄉,大有村,183,58,184,253,-1,-195,-0.543,-77.075
10009120010,雲林縣,崙背鄉,豐榮村,183,73,185,315,-2,-242,-1.081,-76.825
10009120011,雲林縣,崙背鄉,草湖村,206,82,180,243,26,-161,14.444,-66.255
10009120012,雲林縣,崙背鄉,舊庄村,128,42,101,163,27,-121,26.733,-74.233
10009120013,雲林縣,崙背鄉,水尾村,158,90,122,321,36,-231,29.508,-71.963
10009120014,雲林縣,崙背鄉,枋南村,115,41,78,156,37,-115,47.436,-73.718
10009110001,雲林縣,二崙鄉,崙東村,245,84,206,321,39,-237,18.932,-73.832
10009110002,雲林縣,二崙鄉,崙西村,288,108,243,382,45,-274,18.519,-71.728
10009110003,雲林縣,二崙鄉,來惠村,155,99,164,359,-9,-260,-5.488,-72.423
10009110004,雲林縣,二崙鄉,三和村,142,66,146,357,-4,-291,-2.74,-81.513
10009110005,雲林縣,二崙鄉,湳仔村,185,40,183,227,2,-187,1.093,-82.379
10009110006,雲林縣,二崙鄉,田尾村,268,147,209,441,59,-294,28.23,-66.667
10009110007,雲林縣,二崙鄉,定安村,122,44,88,213,34,-169,38.636,-79.343
10009110018,雲林縣,二崙鄉,永定村,177,85,170,391,7,-306,4.118,-78.261
10009110008,雲林縣,二崙鄉,大華村,110,66,91,251,19,-185,20.879,-73.705
10009110009,雲林縣,二崙鄉,義庄村,86,74,51,230,35,-156,68.627,-67.826
10009110010,雲林縣,二崙鄉,楊賢村,144,81,113,341,31,-260,27.434,-76.246
10009110011,雲林縣,二崙鄉,港後村,180,137,163,443,17,-306,10.429,-69.074
10009110012,雲林縣,二崙鄉,大義村,89,33,77,196,12,-163,15.584,-83.163
10009110013,雲林縣,二崙鄉,油車村,244,126,229,424,15,-298,6.55,-70.283
10009110014,雲林縣,二崙鄉,大庄村,153,83,126,282,27,-199,21.429,-70.567
10009110015,雲林縣,二崙鄉,庄西村,90,30,73,158,17,-128,23.288,-81.013
10009110016,雲林縣,二崙鄉,大同村,94,53,77,202,17,-149,22.078,-73.762
10009110017,雲林縣,二崙鄉,復興村,107,49,82,183,25,-134,30.488,-73.224
10009040001,雲林縣,西螺鎮,振興里,223,105,166,366,57,-261,34.337,-71.311
10009040002,雲林縣,西螺鎮,大園里,312,122,270,384,42,-262,15.556,-68.229
10009040003,雲林縣,西螺鎮,廣福里,404,130,342,413,62,-283,18.129,-68.523
10009040004,雲林縣,西螺鎮,正興里,553,157,496,613,57,-456,11.492,-74.388
10009040005,雲林縣,西螺鎮,永安里,71,42,53,96,18,-54,33.962,-56.25
10009040006,雲林縣,西螺鎮,中和里,104,54,87,146,17,-92,19.54,-63.014
10009040007,雲林縣,西螺鎮,福興里,103,39,91,133,12,-94,13.187,-70.677
10009040008,雲林縣,西螺鎮,光華里,171,71,150,222,21,-151,14.0,-68.018
10009040009,雲林縣,西螺鎮,中興里,515,174,412,658,103,-484,25.0,-73.556
10009040010,雲林縣,西螺鎮,漢光里,761,295,579,1014,182,-719,31.434,-70.907
10009040011,雲林縣,西螺鎮,新安里,123,86,105,352,18,-266,17.143,-75.568
10009040012,雲林縣,西螺鎮,新豐里,141,94,132,395,9,-301,6.818,-76.203
10009040017,雲林縣,西螺鎮,大新里,229,81,176,385,53,-304,30.114,-78.961
10009040018,雲林縣,西螺鎮,埤頭里,96,60,81,240,15,-180,18.519,-75.0
10009040019,雲林縣,西螺鎮,東興里,141,62,92,298,49,-236,53.261,-79.195
10009040021,雲林縣,西螺鎮,鹿場里,164,88,148,381,16,-293,10.811,-76.903
10009040020,雲林縣,西螺鎮,廣興里,163,62,143,187,20,-125,13.986,-66.845
10009040022,雲林縣,西螺鎮,頂湳里,118,86,110,272,8,-186,7.273,-68.382
10009040025,雲林縣,西螺鎮,吳厝里,161,64,124,261,37,-197,29.839,-75.479
10009040024,雲林縣,西螺鎮,九隆里,101,50,84,193,17,-143,20.238,-74.093
10009040023,雲林縣,西螺鎮,下湳里,160,29,143,100,17,-71,11.888,-71.0
10009040026,雲林縣,西螺鎮,七座里,118,42,88,219,30,-177,34.091,-80.822
10009040027,雲林縣,西螺鎮,公舘里,186,96,123,335,63,-239,51.22,-71.343
10009040013,雲林縣,西螺鎮,詔安里,161,61,153,220,8,-159,5.229,-72.273
10009040014,雲林縣,西螺鎮,河南里,155,65,116,228,39,-163,33.621,-71.491
10009040015,雲林縣,西螺鎮,安定里,196,106,157,396,39,-290,24.841,-73.232
10009040016,雲林縣,西螺鎮,福田里,152,81,125,378,27,-297,21.6,-78.571
10009090001,雲林縣,莿桐鄉,莿桐村,736,299,640,1035,96,-736,15.0,-71.111
10009090002,雲林縣,莿桐鄉,甘厝村,106,69,90,243,16,-174,17.778,-71.605
10009090003,雲林縣,莿桐鄉,甘西村,221,120,173,419,48,-299,27.746,-71.36
10009090004,雲林縣,莿桐鄉,興桐村,199,77,183,318,16,-241,8.743,-75.786
10009090005,雲林縣,莿桐鄉,義和村,110,68,124,254,-14,-186,-11.29,-73.228
10009090006,雲林縣,莿桐鄉,埔子村,342,162,224,524,118,-362,52.679,-69.084
10009090007,雲林縣,莿桐鄉,大美村,557,195,507,679,50,-484,9.862,-71.281
10009090008,雲林縣,莿桐鄉,埔尾村,232,104,191,333,41,-229,21.466,-68.769
10009090010,雲林縣,莿桐鄉,興貴村,326,104,249,437,77,-333,30.924,-76.201
10009090009,雲林縣,莿桐鄉,饒平村,191,47,140,252,51,-205,36.429,-81.349
10009090011,雲林縣,莿桐鄉,四合村,283,82,253,377,30,-295,11.858,-78.249
10009090012,雲林縣,莿桐鄉,麻園村,220,82,193,305,27,-223,13.99,-73.115
10009090013,雲林縣,莿桐鄉,五華村,175,69,159,307,16,-238,10.063,-77.524
10009090014,雲林縣,莿桐鄉,六合村,293,106,210,466,83,-360,39.524,-77.253
10009100001,雲林縣,林內鄉,林南村,217,53,171,187,46,-134,26.901,-71.658
10009100002,雲林縣,林內鄉,林中村,733,188,574,721,159,-533,27.7,-73.925
10009100003,雲林縣,林內鄉,林北村,311,123,295,466,16,-343,5.424,-73.605
10009100004,雲林縣,林內鄉,坪頂村,93,19,92,80,1,-61,1.087,-76.25
10009100005,雲林縣,林內鄉,林茂村,152,31,131,156,21,-125,16.031,-80.128
10009100006,雲林縣,林內鄉,九芎村,473,123,345,477,128,-354,37.101,-74.214
10009100007,雲林縣,林內鄉,湖本村,99,43,88,138,11,-95,12.5,-68.841
10009100008,雲林縣,林內鄉,烏塗村,226,45,167,214,59,-169,35.329,-78.972
10009100009,雲林縣,林內鄉,烏麻村,233,36,187,158,46,-122,24.599,-77.215
10009100010,雲林縣,林內鄉,重興村,256,91,214,427,42,-336,19.626,-78.689
10009010003,雲林縣,斗六市,信義里,112,43,138,169,-26,-126,-18.841,-74.556
10009010004,雲林縣,斗六市,四維里,127,45,128,148,-1,-103,-0.781,-69.595
10009010005,雲林縣,斗六市,太平里,195,43,176,163,19,-120,10.795,-73.62
10009010006,雲林縣,斗六市,中和里,150,65,137,202,13,-137,9.489,-67.822
10009010007,雲林縣,斗六市,光興里,111,28,148,161,-37,-133,-25.0,-82.609
10009010033,雲林縣,斗六市,鎮西里,798,188,709,724,89,-536,12.553,-74.033
10009010032,雲林縣,斗六市,鎮東里,626,110,571,455,55,-345,9.632,-75.824
10009010039,雲林縣,斗六市,文化里,532,117,514,448,18,-331,3.502,-73.884
10009010008,雲林縣,斗六市,三平里,1168,259,1086,909,82,-650,7.551,-71.507
10009010037,雲林縣,斗六市,明德里,936,244,703,780,233,-536,33.144,-68.718
10009010010,雲林縣,斗六市,鎮北里,708,159,623,538,85,-379,13.644,-70.446
10009010036,雲林縣,斗六市,公誠里,490,114,458,402,32,-288,6.987,-71.642
10009010001,雲林縣,斗六市,忠孝里,304,104,324,307,-20,-203,-6.173,-66.124
10009010002,雲林縣,斗六市,仁愛里,230,94,202,276,28,-182,13.861,-65.942
10009010009,雲林縣,斗六市,八德里,710,184,625,616,85,-432,13.6,-70.13
10009010034,雲林縣,斗六市,公正里,673,163,614,540,59,-377,9.609,-69.815
10009010014,雲林縣,斗六市,重光里,444,114,355,469,89,-355,25.07,-75.693
10009010013,雲林縣,斗六市,林頭里,930,216,813,756,117,-540,14.391,-71.429
10009010038,雲林縣,斗六市,成功里,690,154,609,578,81,-424,13.3,-73.356
10009010012,雲林縣,斗六市,鎮南里,808,219,820,685,-12,-466,-1.463,-68.029
10009010035,雲林縣,斗六市,社口里,504,136,520,435,-16,-299,-3.077,-68.736
10009010011,雲林縣,斗六市,龍潭里,389,106,390,385,-1,-279,-0.256,-72.468
10009010019,雲林縣,斗六市,嘉東里,353,84,246,326,107,-242,43.496,-74.233
10009010018,雲林縣,斗六市,崙峯里,634,120,564,423,70,-303,12.411,-71.631
10009010015,雲林縣,斗六市,溝埧里,175,32,164,138,11,-106,6.707,-76.812
10009010016,雲林縣,斗六市,江厝里,444,90,350,456,94,-366,26.857,-80.263
10009010017,雲林縣,斗六市,三光里,77,31,87,123,-10,-92,-11.494,-74.797
10009010020,雲林縣,斗六市,久安里,518,103,516,464,2,-361,0.388,-77.802
10009010040,雲林縣,斗六市,正心里,470,95,404,416,66,-321,16.337,-77.163
10009010023,雲林縣,斗六市,虎溪里,714,195,564,680,150,-485,26.596,-71.324
10009010022,雲林縣,斗六市,保庄里,1281,295,1121,1149,160,-854,14.273,-74.326
10009010021,雲林縣,斗六市,長平里,468,124,316,412,152,-288,48.101,-69.903
10009010026,雲林縣,斗六市,榴中里,931,241,757,920,174,-679,22.985,-73.804
10009010027,雲林縣,斗六市,榴北里,169,74,150,225,19,-151,12.667,-67.111
10009010028,雲林縣,斗六市,榴南里,438,135,317,375,121,-240,38.17,-64.0
10009010024,雲林縣,斗六市,梅林里,348,89,294,418,54,-329,18.367,-78.708
10009010025,雲林縣,斗六市,湖山里,203,67,167,245,36,-178,21.557,-72.653
10009010030,雲林縣,斗六市,長安里,676,196,469,641,207,-445,44.136,-69.423
10009010029,雲林縣,斗六市,溪洲里,620,165,578,608,42,-443,7.266,-72.862
10009010031,雲林縣,斗六市,十三里,185,73,151,273,34,-200,22.517,-73.26
10009080001,雲林縣,大埤鄉,北和村,108,51,122,167,-14,-116,-11.475,-69.461
10009080009,雲林縣,大埤鄉,吉田村,106,61,72,167,34,-106,47.222,-63.473
10009080010,雲林縣,大埤鄉,豐岡村,103,30,86,113,17,-83,19.767,-73.451
10009080011,雲林縣,大埤鄉,聯美村,133,54,121,204,12,-150,9.917,-73.529
10009080002,雲林縣,大埤鄉,南和村,385,112,301,500,84,-388,27.907,-77.6
10009080003,雲林縣,大埤鄉,大德村,154,48,155,196,-1,-148,-0.645,-75.51
10009080004,雲林縣,大埤鄉,松竹村,115,58,85,241,30,-183,35.294,-75.934
10009080007,雲林縣,大埤鄉,豐田村,300,90,228,348,72,-258,31.579,-74.138
10009080005,雲林縣,大埤鄉,尚義村,311,139,237,424,74,-285,31.224,-67.217
10009080006,雲林縣,大埤鄉,嘉興村,323,111,292,392,31,-281,10.616,-71.684
10009080008,雲林縣,大埤鄉,三結村,191,48,127,258,64,-210,50.394,-81.395
10009080012,雲林縣,大埤鄉,怡然村,135,33,106,167,29,-134,27.358,-80.24
10009080013,雲林縣,大埤鄉,北鎮村,87,32,88,157,-1,-125,-1.136,-79.618
10009080014,雲林縣,大埤鄉,興安村,87,31,75,163,12,-132,16.0,-80.982
10009080015,雲林縣,大埤鄉,西鎮村,91,33,88,133,3,-100,3.409,-75.188
10009020001,雲林縣,斗南鎮,東仁里,238,78,231,276,7,-198,3.03,-71.739
10009020002,雲林縣,斗南鎮,西岐里,486,159,450,436,36,-277,8.0,-63.532
10009020023,雲林縣,斗南鎮,大同里,721,199,570,565,151,-366,26.491,-64.779
10009020003,雲林縣,斗南鎮,南昌里,455,169,351,466,104,-297,29.63,-63.734
10009020004,雲林縣,斗南鎮,北銘里,297,65,307,307,-10,-242,-3.257,-78.827
10009020005,雲林縣,斗南鎮,中天里,240,84,219,280,21,-196,9.589,-70.0
10009020007,雲林縣,斗南鎮,林子里,250,95,205,296,45,-201,21.951,-67.905
10009020008,雲林縣,斗南鎮,石龜里,140,44,120,194,20,-150,16.667,-77.32
10009020022,雲林縣,斗南鎮,石溪里,131,52,120,207,11,-155,9.167,-74.879
10009020009,雲林縣,斗南鎮,靖興里,143,42,130,152,13,-110,10.0,-72.368
10009020010,雲林縣,斗南鎮,新南里,160,41,107,155,53,-114,49.533,-73.548
10009020011,雲林縣,斗南鎮,阿丹里,179,42,157,229,22,-187,14.013,-81.659
10009020012,雲林縣,斗南鎮,將軍里,273,105,238,384,35,-279,14.706,-72.656
10009020006,雲林縣,斗南鎮,舊社里,550,203,437,578,113,-375,25.858,-64.879
10009020016,雲林縣,斗南鎮,明昌里,763,208,610,681,153,-473,25.082,-69.457
10009020024,雲林縣,斗南鎮,僑真里,501,110,392,442,109,-332,27.806,-75.113
10009020017,雲林縣,斗南鎮,大東里,159,56,143,178,16,-122,11.189,-68.539
10009020018,雲林縣,斗南鎮,埤麻里,177,52,163,141,14,-89,8.589,-63.121
10009020019,雲林縣,斗南鎮,西伯里,180,37,168,142,12,-105,7.143,-73.944
10009020020,雲林縣,斗南鎮,新崙里,241,84,204,318,37,-234,18.137,-73.585
10009020013,雲林縣,斗南鎮,東明里,190,48,151,235,39,-187,25.828,-79.574
10009020014,雲林縣,斗南鎮,新光里,543,195,389,661,154,-466,39.589,-70.499
10009020015,雲林縣,斗南鎮,田頭里,454,146,332,464,122,-318,36.747,-68.534
10009020021,雲林縣,斗南鎮,小東里,220,107,178,382,42,-275,23.596,-71.99
10009070007,雲林縣,古坑鄉,棋盤村,292,100,254,443,38,-343,14.961,-77.427
10009070006,雲林縣,古坑鄉,新庄村,259,114,210,370,49,-256,23.333,-69.189
10009070005,雲林縣,古坑鄉,東和村,554,161,430,617,124,-456,28.837,-73.906
10009070004,雲林縣,古坑鄉,荷苞村,273,87,222,272,51,-185,22.973,-68.015
10009070003,雲林縣,古坑鄉,高林村,209,62,148,249,61,-187,41.216,-75.1
10009070001,雲林縣,古坑鄉,水碓村,239,59,184,245,55,-186,29.891,-75.918
10009070002,雲林縣,古坑鄉,田心村,253,62,221,197,32,-135,14.48,-68.528
10009070017,雲林縣,古坑鄉,古坑村,412,89,371,409,41,-320,11.051,-78.24
10009070018,雲林縣,古坑鄉,朝陽村,374,99,362,401,12,-302,3.315,-75.312
10009070019,雲林縣,古坑鄉,西平村,290,101,251,331,39,-230,15.538,-69.486
10009070020,雲林縣,古坑鄉,湳仔村,165,53,115,133,50,-80,43.478,-60.15
10009070010,雲林縣,古坑鄉,永光村,338,105,290,394,48,-289,16.552,-73.35
10009070015,雲林縣,古坑鄉,永昌村,355,138,325,426,30,-288,9.231,-67.606
10009070016,雲林縣,古坑鄉,麻園村,156,52,107,222,49,-170,45.794,-76.577
10009070012,雲林縣,古坑鄉,崁腳村,231,76,176,182,55,-106,31.25,-58.242
10009070009,雲林縣,古坑鄉,華南村,46,19,29,76,17,-57,58.621,-75.0
10009070008,雲林縣,古坑鄉,華山村,86,19,79,138,7,-119,8.861,-86.232
10009070011,雲林縣,古坑鄉,桂林村,136,49,99,243,37,-194,37.374,-79.835
10009070013,雲林縣,古坑鄉,樟湖村,53,15,43,57,10,-42,23.256,-73.684
10009070014,雲林縣,古坑鄉,草嶺村,63,21,76,122,-13,-101,-17.105,-82.787
09007010001,連江縣,南竿鄉,介壽村,377,25,551,94,-174,-69,-31.579,-73.404
09007010002,連江縣,南竿鄉,復興村,187,14,408,61,-221,-47,-54.167,-77.049
09007010003,連江縣,南竿鄉,福沃村,124,6,408,61,-284,-55,-69.608,-90.164
09007010004,連江縣,南竿鄉,清水村,216,11,279,53,-63,-42,-22.581,-79.245
09007010007,連江縣,南竿鄉,馬祖村、珠螺村、四維村,53,4,374,64,-321,-60,-85.829,-93.75
09007010008,連江縣,南竿鄉,馬祖村、珠螺村、四維村,53,4,279,53,-226,-49,-81.004,-92.453
09007010009,連江縣,南竿鄉,馬祖村、珠螺村、四維村,53,4,374,64,-321,-60,-85.829,-93.75
09007010005,連江縣,南竿鄉,仁愛村、津沙村,123,10,374,64,-251,-54,-67.112,-84.375
09007010006,連江縣,南竿鄉,仁愛村、津沙村,123,10,374,64,-251,-54,-67.112,-84.375
09007020001,連江縣,北竿鄉,塘岐村、后沃村,104,9,277,52,-173,-43,-62.455,-82.692
09007020002,連江縣,北竿鄉,塘岐村、后沃村,104,9,277,52,-173,-43,-62.455,-82.692
09007020003,連江縣,北竿鄉,橋仔村、芹壁村、坂里村、白沙村,45,2,246,42,-201,-40,-81.707,-95.238
09007020004,連江縣,北竿鄉,橋仔村、芹壁村、坂里村、白沙村,45,2,246,42,-201,-40,-81.707,-95.238
09007020005,連江縣,北竿鄉,橋仔村、芹壁村、坂里村、白沙村,45,2,246,42,-201,-40,-81.707,-95.238
09007020006,連江縣,北竿鄉,橋仔村、芹壁村、坂里村、白沙村,45,2,246,42,-201,-40,-81.707,-95.238
,臺南市,西港區,檨林里,199,116,,,,,,
,臺南市,安南區,南里,815,390,,,,,,
,臺南市,安南區,公里,188,125,,,,,,
,南投縣,魚池鄉,新城村,382,164,,,,,,
,屏東縣,瑪家鄉,三和村,566,163,,,,,,
,連江縣,莒光鄉,青帆村、田沃村、西坵村,98,7,,,,,,
,連江縣,莒光鄉,福正村、大坪村,110,3,,,,,,
,連江縣,東引鄉,中柳村、樂華村,218,8,,,,,,
